dd84ea7,{'file_name': 'dd84ea7'},md,38,0,38
48d5f81,{'file_name': '48d5f81'},md,10,0,10
bbcbbe7,{'file_name': 'bbcbbe7'},md,20,0,20
958a2e3,{'file_name': '958a2e3'},cpp,8,3,11
6fb4ced,{'file_name': '6fb4ced'},md,22,29,51
5b37379,{'file_name': '5b37379'},cpp,2,1,3
43a3553,{'file_name': '43a3553'},cpp,10,4,14
d818587,{'file_name': 'd818587'},cpp,2,0,2
a420028,{'file_name': 'a420028'},cpp,47,44,91
50e4a6b,{'file_name': '50e4a6b'},h,1,0,1
2b25157,{'file_name': '2b25157'},h,13,1,14
4f8f452,{'file_name': '4f8f452'},cpp,5,3,8
1f096f6,{'file_name': '1f096f6'},h,1,3,4
3448d53,{'file_name': '3448d53'},cpp,45,0,45
dcbdb22,{'file_name': 'dcbdb22'},h,1,0,1
89e2146,{'file_name': '89e2146'},cpp,92,0,92
9f1e8ee,{'file_name': '9f1e8ee'},h,24,0,24
4b8ce99,{'file_name': '4b8ce99'},cpp,360,11,371
321856e,{'file_name': '321856e'},h,21,1,22
48bbef0,{'file_name': '48bbef0'},h,8,3,11
5812e5d,{'file_name': '5812e5d'},cpp,33,4,37
ea61309,{'file_name': 'ea61309'},h,9,0,9
0a3722a,{'file_name': '0a3722a'},cpp,86,2,88
242291c,{'file_name': '242291c'},cpp,264,51,315
ff3b07d,{'file_name': 'ff3b07d'},h,10,0,10
8643de3,{'file_name': '8643de3'},cpp,36,11,47
bc392e3,{'file_name': 'bc392e3'},cpp,19,11,30
2062d9a,{'file_name': '2062d9a'},cpp,3,3,6
ea77156,{'file_name': 'ea77156'},qrc,1,0,1
17d956c,{'file_name': '17d956c'},png,0,0,0
b4bcde6,{'file_name': 'b4bcde6'},cpp,3,2,5
a63160f,{'file_name': 'a63160f'},pro,4,0,4
2a0a084,{'file_name': '2a0a084'},cpp,15,4,19
7ead560,{'file_name': '7ead560'},cpp,71,0,71
51082cb,{'file_name': '51082cb'},h,24,0,24
531ee30,{'file_name': '531ee30'},cpp,23,74,97
bf8c114,{'file_name': 'bf8c114'},h,2,6,8
b3bb302,{'file_name': 'b3bb302'},cpp,9,5,14
57c5d06,{'file_name': '57c5d06'},cpp,12,5,17
bd7595b,{'file_name': 'bd7595b'},h,1,0,1
dd84ea7,{'file_name': 'dd84ea7'},md,38,0,38
48d5f81,{'file_name': '48d5f81'},md,10,0,10
bbcbbe7,{'file_name': 'bbcbbe7'},md,20,0,20
4d8b1b2,{'file_name': '4d8b1b2'},h,26,11,37
573a6c4,{'file_name': '573a6c4'},cpp,2,2,4
2d361c5,{'file_name': '2d361c5'},h,7,0,7
f0be843,{'file_name': 'f0be843'},cpp,93,56,149
8be309f,{'file_name': '8be309f'},h,5,2,7
2fd84d9,{'file_name': '2fd84d9'},cpp,2,1,3
2ff1907,{'file_name': '2ff1907'},cpp,36,7,43
18be948,{'file_name': '18be948'},h,3,0,3
8c77f3a,{'file_name': '8c77f3a'},h,1,0,1
b5b972f,{'file_name': 'b5b972f'},cpp,4,0,4
9cc7d62,{'file_name': '9cc7d62'},h,1,0,1
30f6df4,{'file_name': '30f6df4'},cpp,6,1,7
24167d3,{'file_name': '24167d3'},cpp,8,0,8
75dd707,{'file_name': '75dd707'},h,1,0,1
18b89d3,{'file_name': '18b89d3'},h,3,2,5
6d963a6,{'file_name': '6d963a6'},cpp,7,5,12
5f38f29,{'file_name': '5f38f29'},cpp,106,56,162
8bf706d,{'file_name': '8bf706d'},cpp,23,17,40
f5f0da6,{'file_name': 'f5f0da6'},cpp,2,2,4
330bb95,{'file_name': '330bb95'},json,1,0,1
8a4afa0,{'file_name': '8a4afa0'},xml,3,0,3
027dbf9,{'file_name': '027dbf9'},cpp,1,1,2
81cc690,{'file_name': '81cc690'},cpp,5,0,5
2de160c,{'file_name': '2de160c'},cpp,2,1,3
55d824f,{'file_name': '55d824f'},h,2,0,2
d184fbf,{'file_name': 'd184fbf'},cpp,11,0,11
5756d9c,{'file_name': '5756d9c'},cpp,32,5,37
6745802,{'file_name': '6745802'},h,1,0,1
5fa3960,{'file_name': '5fa3960'},cpp,19,6,25
8770a50,{'file_name': '8770a50'},h,2,0,2
e230128,{'file_name': 'e230128'},cpp,0,137,137
51dfc83,{'file_name': '51dfc83'},h,0,21,21
251b416,{'file_name': '251b416'},cpp,0,130,130
d9ce551,{'file_name': 'd9ce551'},h,0,35,35
bc208cf,{'file_name': 'bc208cf'},cpp,21,11,32
e4ea4a8,{'file_name': 'e4ea4a8'},cpp,0,282,282
41c7e1f,{'file_name': '41c7e1f'},h,0,41,41
8ff0bf8,{'file_name': '8ff0bf8'},cpp,4,2,6
1710dbe,{'file_name': '1710dbe'},h,2,2,4
cc3f452,{'file_name': 'cc3f452'},qrc,3,0,3
36c606f,{'file_name': '36c606f'},pro,8,6,14
4415fa4,{'file_name': '4415fa4'},cpp,0,1,1
88c9504,{'file_name': '88c9504'},cpp,137,0,137
5663a4a,{'file_name': '5663a4a'},h,21,0,21
251b416,{'file_name': '251b416'},cpp,130,0,130
d9ce551,{'file_name': 'd9ce551'},h,35,0,35
d398b6a,{'file_name': 'd398b6a'},cpp,217,0,217
6bebe48,{'file_name': '6bebe48'},h,25,0,25
ed53912,{'file_name': 'ed53912'},cpp,282,0,282
4ce429d,{'file_name': '4ce429d'},h,41,0,41
90b9e9b,{'file_name': '90b9e9b'},png,0,0,0
e29666e,{'file_name': 'e29666e'},png,0,0,0
54eaf95,{'file_name': '54eaf95'},png,0,0,0
d6cd86b,{'file_name': 'd6cd86b'},h,1,0,1
872cd47,{'file_name': '872cd47'},h,5,2,7
a2c7d11,{'file_name': 'a2c7d11'},h,2,2,4
9850796,{'file_name': '9850796'},cpp,3,20,23
b8b500a,{'file_name': 'b8b500a'},h,2,4,6
626cec5,{'file_name': '626cec5'},cpp,137,16,153
e8f1bda,{'file_name': 'e8f1bda'},h,20,6,26
aae51c6,{'file_name': 'aae51c6'},h,12,0,12
89b87b4,{'file_name': '89b87b4'},cpp,0,1,1
3b2131c,{'file_name': '3b2131c'},cpp,148,43,191
e4ea4a8,{'file_name': 'e4ea4a8'},cpp,17,1,18
41c7e1f,{'file_name': '41c7e1f'},h,4,0,4
9e4c749,{'file_name': '9e4c749'},cpp,26,5,31
3e96165,{'file_name': '3e96165'},qrc,2,0,2
d2cac8c,{'file_name': 'd2cac8c'},png,0,0,0
4933dab,{'file_name': '4933dab'},png,0,0,0
bd70e5f,{'file_name': 'bd70e5f'},cpp,1,1,2
c365d30,{'file_name': 'c365d30'},cpp,0,2,2
c0adce3,{'file_name': 'c0adce3'},md,6,2,8
03c5b84,{'file_name': '03c5b84'},h,16,0,16
2fa05bd,{'file_name': '2fa05bd'},h,8,3,11
523d32b,{'file_name': '523d32b'},cpp,14,43,57
96c223a,{'file_name': '96c223a'},h,6,14,20
4db5d43,{'file_name': '4db5d43'},cpp,18,55,73
9bcf09a,{'file_name': '9bcf09a'},h,2,2,4
d2803e4,{'file_name': 'd2803e4'},cpp,11,10,21
db07736,{'file_name': 'db07736'},h,8,8,16
1521fe1,{'file_name': '1521fe1'},cpp,22,0,22
920bc72,{'file_name': '920bc72'},h,19,0,19
d47c233,{'file_name': 'd47c233'},h,5,3,8
ae9c559,{'file_name': 'ae9c559'},cpp,16,1,17
0856782,{'file_name': '0856782'},h,10,3,13
e230128,{'file_name': 'e230128'},cpp,4,4,8
e4969cf,{'file_name': 'e4969cf'},cpp,5,1,6
c32653d,{'file_name': 'c32653d'},cpp,31,21,52
7661ed1,{'file_name': '7661ed1'},h,27,11,38
764c5e4,{'file_name': '764c5e4'},pro,3,0,3
fd047a5,{'file_name': 'fd047a5'},cpp,14,0,14
540cddc,{'file_name': '540cddc'},h,2,0,2
9c3b1fd,{'file_name': '9c3b1fd'},cpp,8,7,15
f635bbe,{'file_name': 'f635bbe'},h,3,0,3
6130008,{'file_name': '6130008'},cpp,2,1,3
63abfe4,{'file_name': '63abfe4'},h,2,1,3
fb3d0a9,{'file_name': 'fb3d0a9'},cpp,19,22,41
523322c,{'file_name': '523322c'},h,2,0,2
55f3bb3,{'file_name': '55f3bb3'},cpp,2,0,2
e6f7090,{'file_name': 'e6f7090'},cpp,1,1,2
facdd21,{'file_name': 'facdd21'},h,0,0,0
9a70603,{'file_name': '9a70603'},cpp,1,1,2
ef71925,{'file_name': 'ef71925'},h,0,0,0
f06f8ae,{'file_name': 'f06f8ae'},cpp,49,0,49
209a4fc,{'file_name': '209a4fc'},h,26,0,26
a1f68a2,{'file_name': 'a1f68a2'},h,2,2,4
de3f27c,{'file_name': 'de3f27c'},h,13,0,13
e1aa1b6,{'file_name': 'e1aa1b6'},cpp,6,0,6
cb8ee80,{'file_name': 'cb8ee80'},h,11,0,11
e3a3de3,{'file_name': 'e3a3de3'},cpp,49,12,61
e5969de,{'file_name': 'e5969de'},cpp,3,0,3
ca01f01,{'file_name': 'ca01f01'},cpp,5,0,5
42efab2,{'file_name': '42efab2'},pro,9,3,12
086ad3b,{'file_name': '086ad3b'},cpp,0,1,1
7a90996,{'file_name': '7a90996'},cpp,9,0,9
1cadd52,{'file_name': '1cadd52'},h,1,0,1
a98132d,{'file_name': 'a98132d'},cpp,2,2,4
c0adce3,{'file_name': 'c0adce3'},md,1,1,2
16961c0,{'file_name': '16961c0'},md,5,1,6
f288702,{'file_name': 'f288702'},LICENSE,674,0,674
da5563b,{'file_name': 'da5563b'},md,111,0,111
58e982d,{'file_name': '58e982d'},h,2,1,3
a03aeb0,{'file_name': 'a03aeb0'},cpp,5,0,5
2e86315,{'file_name': '2e86315'},cpp,3,3,6
4b5646d,{'file_name': '4b5646d'},h,1,2,3
509e7e7,{'file_name': '509e7e7'},cpp,1,0,1
21c6dce,{'file_name': '21c6dce'},cpp,9,3,12
d9f1cef,{'file_name': 'd9f1cef'},h,2,2,4
ff5dff6,{'file_name': 'ff5dff6'},cpp,48,48,96
46a9cb7,{'file_name': '46a9cb7'},h,3,3,6
8dad0e8,{'file_name': '8dad0e8'},cpp,8,29,37
facdd21,{'file_name': 'facdd21'},h,2,2,4
0dc23fc,{'file_name': '0dc23fc'},cpp,16,15,31
ef71925,{'file_name': 'ef71925'},h,3,3,6
db6df3d,{'file_name': 'db6df3d'},cpp,56,13,69
726f8ed,{'file_name': '726f8ed'},h,0,1,1
33a6854,{'file_name': '33a6854'},json,1,0,1
93a260f,{'file_name': '93a260f'},qrc,2,1,3
417ccee,{'file_name': '417ccee'},png,0,0,0
b6e7006,{'file_name': 'b6e7006'},svg,0,0,0
73fcb94,{'file_name': '73fcb94'},pro,8,6,14
382d47b,{'file_name': '382d47b'},aps,0,0,0
583d2f7,{'file_name': '583d2f7'},ico,0,0,0
ca89459,{'file_name': 'ca89459'},cpp,7,3,10
69fdd7f,{'file_name': '69fdd7f'},cpp,2,1,3
a7414ed,{'file_name': 'a7414ed'},h,1,0,1
5ee80da,{'file_name': '5ee80da'},cpp,8,0,8
e9b5095,{'file_name': 'e9b5095'},h,37,0,37
2d1677e,{'file_name': '2d1677e'},cpp,3,1,4
47d59cb,{'file_name': '47d59cb'},cpp,5,0,5
2fe5248,{'file_name': '2fe5248'},cpp,2,1,3
7ada8e9,{'file_name': '7ada8e9'},cpp,63,33,96
158d8c9,{'file_name': '158d8c9'},h,3,2,5
ef40faf,{'file_name': 'ef40faf'},cpp,2,0,2
a741907,{'file_name': 'a741907'},cpp,2,3,5
30d671c,{'file_name': '30d671c'},h,59,0,59
78bccf4,{'file_name': '78bccf4'},cpp,1,1,2
70f672e,{'file_name': '70f672e'},cpp,108,0,108
46a7682,{'file_name': '46a7682'},h,16,0,16
3096f51,{'file_name': '3096f51'},cpp,0,1,1
135192a,{'file_name': '135192a'},cpp,1,1,2
8d22a85,{'file_name': '8d22a85'},cpp,11,7,18
2661290,{'file_name': '2661290'},h,1,1,2
fa3e479,{'file_name': 'fa3e479'},h,1,0,1
71541b8,{'file_name': '71541b8'},cpp,4,4,8
615a341,{'file_name': '615a341'},cpp,2,1,3
4762e5b,{'file_name': '4762e5b'},cpp,47,10,57
3c62c94,{'file_name': '3c62c94'},h,2,0,2
2ba3a65,{'file_name': '2ba3a65'},cpp,0,1,1
7b5e832,{'file_name': '7b5e832'},cpp,3,2,5
5f026b2,{'file_name': '5f026b2'},h,1,1,2
f5824fd,{'file_name': 'f5824fd'},cpp,22,8,30
903c978,{'file_name': '903c978'},h,1,0,1
7054b6e,{'file_name': '7054b6e'},qrc,1,1,2
fafe262,{'file_name': 'fafe262'},pro,21,1,22
d56687f,{'file_name': 'd56687f'},cpp,3,1,4
9cb0f42,{'file_name': '9cb0f42'},cpp,5,5,10
1e939cc,{'file_name': '1e939cc'},cpp,174,0,174
65f4668,{'file_name': '65f4668'},h,55,0,55
1c17407,{'file_name': '1c17407'},cpp,49,0,49
46e8caa,{'file_name': '46e8caa'},h,30,0,30
332af92,{'file_name': '332af92'},cpp,32,0,32
1c490f4,{'file_name': '1c490f4'},h,29,0,29
c3f45b7,{'file_name': 'c3f45b7'},cpp,358,0,358
3b7e4dc,{'file_name': '3b7e4dc'},h,45,0,45
aefdf16,{'file_name': 'aefdf16'},cpp,6,0,6
0cfea82,{'file_name': '0cfea82'},h,3,1,4
6b52b87,{'file_name': '6b52b87'},cpp,1,0,1
cc16447,{'file_name': 'cc16447'},cpp,6,0,6
916d794,{'file_name': '916d794'},cpp,311,60,371
f9340c3,{'file_name': 'f9340c3'},h,17,0,17
de2773f,{'file_name': 'de2773f'},h,303,0,303
da5563b,{'file_name': 'da5563b'},md,1,1,2
f288702,{'file_name': 'f288702'},LICENSE,674,0,674
f288702,{'file_name': 'f288702'},LICENSE,674,0,674
4d82418,{'file_name': '4d82418'},md,0,111,111
4d82418,{'file_name': '4d82418'},md,111,0,111
4d82418,{'file_name': '4d82418'},md,111,0,111
9cb1d16,{'file_name': '9cb1d16'},h,2,1,3
d07d621,{'file_name': 'd07d621'},cpp,1,1,2
e4bbf08,{'file_name': 'e4bbf08'},h,39,0,39
8426e44,{'file_name': '8426e44'},cpp,2,0,2
482bd6a,{'file_name': '482bd6a'},h,1,0,1
1d0438b,{'file_name': '1d0438b'},cpp,28,11,39
1718cd3,{'file_name': '1718cd3'},h,9,1,10
6a4f7bd,{'file_name': '6a4f7bd'},cpp,10,2,12
a76c8eb,{'file_name': 'a76c8eb'},h,11,1,12
75a53e4,{'file_name': '75a53e4'},cpp,7,1,8
884a816,{'file_name': '884a816'},cpp,72,8,80
ff0d0a4,{'file_name': 'ff0d0a4'},h,6,0,6
2f7bb58,{'file_name': '2f7bb58'},cpp,10,1,11
c970163,{'file_name': 'c970163'},h,1,0,1
15bb5c9,{'file_name': '15bb5c9'},h,1,1,2
ee56257,{'file_name': 'ee56257'},h,1,1,2
56d7d47,{'file_name': '56d7d47'},cpp,136,0,136
51dfc83,{'file_name': '51dfc83'},h,21,0,21
2a6223b,{'file_name': '2a6223b'},cpp,14,12,26
4666909,{'file_name': '4666909'},h,1,1,2
b384796,{'file_name': 'b384796'},cpp,2,1,3
0c4f176,{'file_name': '0c4f176'},h,1,1,2
268ab74,{'file_name': '268ab74'},cpp,16,15,31
9f43264,{'file_name': '9f43264'},cpp,24,6,30
5998f8b,{'file_name': '5998f8b'},h,2,2,4
f7728fb,{'file_name': 'f7728fb'},cpp,86,34,120
726f8ed,{'file_name': '726f8ed'},h,1,0,1
43dcab1,{'file_name': '43dcab1'},cpp,5,2,7
eeae210,{'file_name': 'eeae210'},h,1,1,2
929cb63,{'file_name': '929cb63'},cpp,37,0,37
244c1a5,{'file_name': '244c1a5'},h,21,0,21
98e6214,{'file_name': '98e6214'},cpp,34,58,92
6139fd2,{'file_name': '6139fd2'},h,4,0,4
30f0a2d,{'file_name': '30f0a2d'},cpp,92,1,93
3392bc8,{'file_name': '3392bc8'},h,3,2,5
048ea50,{'file_name': '048ea50'},xml,11,0,11
addff7e,{'file_name': 'addff7e'},json,24,0,24
a3166de,{'file_name': 'a3166de'},xml,22,0,22
ab45049,{'file_name': 'ab45049'},qrc,7,4,11
6ec9256,{'file_name': '6ec9256'},png,0,0,0
c22d0ae,{'file_name': 'c22d0ae'},cpp,3,2,5
a9b4f4a,{'file_name': 'a9b4f4a'},pro,7,0,7
c6f1756,{'file_name': 'c6f1756'},cpp,4,1,5
6b703bd,{'file_name': '6b703bd'},cpp,25,17,42
c36464c,{'file_name': 'c36464c'},h,1,0,1
ea6a364,{'file_name': 'ea6a364'},cpp,0,2,2
590bfe5,{'file_name': '590bfe5'},cpp,5,1,6
cff4743,{'file_name': 'cff4743'},json,0,9,9
cff4743,{'file_name': 'cff4743'},json,9,0,9
344332c,{'file_name': '344332c'},h,1,1,2
b7e0f8f,{'file_name': 'b7e0f8f'},h,17,1,18
1534014,{'file_name': '1534014'},h,62,4,66
7a77f77,{'file_name': '7a77f77'},cpp,82,0,82
2bd5d7f,{'file_name': '2bd5d7f'},h,45,0,45
2eaf04d,{'file_name': '2eaf04d'},cpp,93,0,93
1f636ef,{'file_name': '1f636ef'},h,15,0,15
e5ae7fc,{'file_name': 'e5ae7fc'},h,10,0,10
9a422fe,{'file_name': '9a422fe'},cpp,33,4,37
aaf5df2,{'file_name': 'aaf5df2'},h,8,1,9
219ee87,{'file_name': '219ee87'},cpp,290,3,293
18b074a,{'file_name': '18b074a'},h,28,8,36
da2e9e8,{'file_name': 'da2e9e8'},cpp,94,0,94
d6f3e20,{'file_name': 'd6f3e20'},h,34,0,34
f3cde10,{'file_name': 'f3cde10'},cpp,4,0,4
805a98c,{'file_name': '805a98c'},h,5,2,7
9b8ae3e,{'file_name': '9b8ae3e'},cpp,84,0,84
6dec96b,{'file_name': '6dec96b'},h,30,0,30
ff2a773,{'file_name': 'ff2a773'},cpp,57,16,73
c105e73,{'file_name': 'c105e73'},h,2,0,2
7f82d93,{'file_name': '7f82d93'},cpp,8,3,11
c3c800a,{'file_name': 'c3c800a'},h,5,4,9
ba59158,{'file_name': 'ba59158'},cpp,76,107,183
0cce4a7,{'file_name': '0cce4a7'},h,9,10,19
3eac905,{'file_name': '3eac905'},cpp,91,0,91
00b2f43,{'file_name': '00b2f43'},h,31,0,31
19242dc,{'file_name': '19242dc'},cpp,24,5,29
61b4d9a,{'file_name': '61b4d9a'},h,1,2,3
e5cdc71,{'file_name': 'e5cdc71'},cpp,27,2,29
3c2a6b9,{'file_name': '3c2a6b9'},h,2,0,2
06eac23,{'file_name': '06eac23'},pro,20,2,22
1a8efc0,{'file_name': '1a8efc0'},cpp,8,3,11
833213b,{'file_name': '833213b'},h,2,2,4
1e2d3e2,{'file_name': '1e2d3e2'},cpp,7,1,8
24d9716,{'file_name': '24d9716'},cpp,45,1,46
553dada,{'file_name': '553dada'},h,5,2,7
db6b9e4,{'file_name': 'db6b9e4'},cpp,10,6,16
e2fc7d2,{'file_name': 'e2fc7d2'},cpp,4,3,7
1702601,{'file_name': '1702601'},h,2,1,3
27a0310,{'file_name': '27a0310'},cpp,85,11,96
cf5effc,{'file_name': 'cf5effc'},h,1,0,1
fb662d5,{'file_name': 'fb662d5'},cpp,8,3,11
833213b,{'file_name': '833213b'},h,2,2,4
d8d5851,{'file_name': 'd8d5851'},cpp,77,31,108
be530bc,{'file_name': 'be530bc'},h,2,0,2
fa8d4cf,{'file_name': 'fa8d4cf'},h,1,0,1
c056bd4,{'file_name': 'c056bd4'},cpp,0,13,13
c995580,{'file_name': 'c995580'},h,0,15,15
3ab6bb4,{'file_name': '3ab6bb4'},pro,30,0,30
ec7a50f,{'file_name': 'ec7a50f'},h,12,0,12
e807b5f,{'file_name': 'e807b5f'},cpp,6,1,7
7f0b088,{'file_name': '7f0b088'},h,8,1,9
c53ae55,{'file_name': 'c53ae55'},cpp,30,0,30
7665ad9,{'file_name': '7665ad9'},h,3,0,3
a917d12,{'file_name': 'a917d12'},h,7,1,8
251b416,{'file_name': '251b416'},cpp,130,0,130
d9ce551,{'file_name': 'd9ce551'},h,35,0,35
7324619,{'file_name': '7324619'},cpp,52,23,75
1a2a066,{'file_name': '1a2a066'},h,4,0,4
af05824,{'file_name': 'af05824'},cpp,116,1,117
c627956,{'file_name': 'c627956'},h,5,0,5
f99cf06,{'file_name': 'f99cf06'},cpp,96,35,131
c0fc225,{'file_name': 'c0fc225'},h,12,6,18
64a974a,{'file_name': '64a974a'},cpp,6,1,7
54c2f32,{'file_name': '54c2f32'},h,1,0,1
4b0e07a,{'file_name': '4b0e07a'},cpp,49,2,51
70cae5d,{'file_name': '70cae5d'},h,1,0,1
463ae52,{'file_name': '463ae52'},cpp,0,1,1
e77528f,{'file_name': 'e77528f'},xml,6,0,6
516272b,{'file_name': '516272b'},qrc,3,0,3
2d0a2c1,{'file_name': '2d0a2c1'},png,0,0,0
c738d2a,{'file_name': 'c738d2a'},qss,8,10,18
ad329bb,{'file_name': 'ad329bb'},svg,2,0,2
67d6bbf,{'file_name': '67d6bbf'},png,0,0,0
a9d8f8e,{'file_name': 'a9d8f8e'},cpp,33,0,33
65e21b5,{'file_name': '65e21b5'},h,12,0,12
64dab33,{'file_name': '64dab33'},pro,11,2,13
4ea3655,{'file_name': '4ea3655'},cpp,163,0,163
92d2561,{'file_name': '92d2561'},h,53,0,53
d973c5d,{'file_name': 'd973c5d'},cpp,1,1,2
ab5cc46,{'file_name': 'ab5cc46'},cpp,33,1,34
1971d0a,{'file_name': '1971d0a'},cpp,0,1,1
f8d6951,{'file_name': 'f8d6951'},h,0,1,1
681cd85,{'file_name': '681cd85'},cpp,1,2,3
640a918,{'file_name': '640a918'},h,1,1,2
ee466f7,{'file_name': 'ee466f7'},cpp,22,1,23
a038598,{'file_name': 'a038598'},h,4,0,4
3aa829d,{'file_name': '3aa829d'},cpp,82,4,86
73eadb0,{'file_name': '73eadb0'},h,2,1,3
4ea3655,{'file_name': '4ea3655'},cpp,8,18,26
92d2561,{'file_name': '92d2561'},h,1,1,2
8f6ed6a,{'file_name': '8f6ed6a'},cpp,4,0,4
3b33da5,{'file_name': '3b33da5'},h,1,1,2
fab7372,{'file_name': 'fab7372'},gitignore,73,0,73
3ab6bb4,{'file_name': '3ab6bb4'},pro,30,0,30
ec7a50f,{'file_name': 'ec7a50f'},h,12,0,12
79299d5,{'file_name': '79299d5'},cpp,169,0,169
21cd320,{'file_name': '21cd320'},h,53,0,53
680a6f8,{'file_name': '680a6f8'},h,3,2,5
27620a3,{'file_name': '27620a3'},h,12,0,12
1b0f290,{'file_name': '1b0f290'},cpp,3,1,4
da62fea,{'file_name': 'da62fea'},h,3,1,4
3d58480,{'file_name': '3d58480'},cpp,65,24,89
31de85e,{'file_name': '31de85e'},h,13,1,14
b7d1ef3,{'file_name': 'b7d1ef3'},h,15,0,15
191cd83,{'file_name': '191cd83'},h,19,0,19
cbf76d0,{'file_name': 'cbf76d0'},h,11,1,12
1874664,{'file_name': '1874664'},h,14,0,14
efb898a,{'file_name': 'efb898a'},cpp,62,0,62
c9f6bda,{'file_name': 'c9f6bda'},h,23,0,23
3523d12,{'file_name': '3523d12'},cpp,113,0,113
bb29ca0,{'file_name': 'bb29ca0'},h,22,0,22
d632007,{'file_name': 'd632007'},cpp,228,0,228
aeef848,{'file_name': 'aeef848'},h,25,0,25
6dc6f98,{'file_name': '6dc6f98'},cpp,121,36,157
0b2a093,{'file_name': '0b2a093'},h,15,4,19
8f8e0b2,{'file_name': '8f8e0b2'},cpp,71,15,86
cdfb03c,{'file_name': 'cdfb03c'},h,10,7,17
cbd8938,{'file_name': 'cbd8938'},cpp,115,22,137
909b274,{'file_name': '909b274'},h,12,1,13
1151a27,{'file_name': '1151a27'},cpp,92,15,107
ae0df28,{'file_name': 'ae0df28'},h,26,3,29
6769a95,{'file_name': '6769a95'},cpp,0,55,55
e76ced5,{'file_name': 'e76ced5'},cpp,66,0,66
765210f,{'file_name': '765210f'},h,26,9,35
935ec44,{'file_name': '935ec44'},cpp,42,3,45
0a19953,{'file_name': '0a19953'},h,6,0,6
bbebf5e,{'file_name': 'bbebf5e'},cpp,218,10,228
572dca5,{'file_name': '572dca5'},h,15,1,16
fea6a5e,{'file_name': 'fea6a5e'},cpp,2,1,3
242722c,{'file_name': '242722c'},h,1,1,2
7aa5422,{'file_name': '7aa5422'},svg,0,1,1
d1c20ac,{'file_name': 'd1c20ac'},svg,0,1,1
b25193a,{'file_name': 'b25193a'},qrc,12,0,12
2edd26d,{'file_name': '2edd26d'},svg,2,0,2
11d073b,{'file_name': '11d073b'},svg,2,0,2
cd16c4f,{'file_name': 'cd16c4f'},png,0,0,0
9bf0e17,{'file_name': '9bf0e17'},png,0,0,0
fca7ee9,{'file_name': 'fca7ee9'},png,0,0,0
83ee128,{'file_name': '83ee128'},png,0,0,0
08fbf48,{'file_name': '08fbf48'},png,0,0,0
d2712da,{'file_name': 'd2712da'},png,0,0,0
4d6b7ca,{'file_name': '4d6b7ca'},png,0,0,0
e19a42c,{'file_name': 'e19a42c'},png,0,0,0
62c5b3a,{'file_name': '62c5b3a'},png,0,0,0
eaa4661,{'file_name': 'eaa4661'},cpp,91,0,91
8a4ecfd,{'file_name': '8a4ecfd'},h,32,0,32
f828c5f,{'file_name': 'f828c5f'},pro,13,2,15
9b17fcf,{'file_name': '9b17fcf'},cpp,1,1,2
7d63e29,{'file_name': '7d63e29'},cpp,12,0,12
aad4cdf,{'file_name': 'aad4cdf'},h,3,0,3
fda1b09,{'file_name': 'fda1b09'},h,2,0,2
cbf8310,{'file_name': 'cbf8310'},cpp,9,6,15
aabb55b,{'file_name': 'aabb55b'},cpp,7,0,7
f9c5e5b,{'file_name': 'f9c5e5b'},h,3,2,5
0c58f90,{'file_name': '0c58f90'},cpp,17,2,19
9ffcad1,{'file_name': '9ffcad1'},h,2,2,4
613a097,{'file_name': '613a097'},h,11,0,11
5515d11,{'file_name': '5515d11'},h,1,0,1
770df82,{'file_name': '770df82'},h,3,0,3
8bbfec5,{'file_name': '8bbfec5'},h,4,0,4
2093464,{'file_name': '2093464'},cpp,5,0,5
2745186,{'file_name': '2745186'},h,1,0,1
a181ce5,{'file_name': 'a181ce5'},h,18,0,18
18af7ee,{'file_name': '18af7ee'},cpp,143,0,143
4c0827b,{'file_name': '4c0827b'},h,29,2,31
ddfe0eb,{'file_name': 'ddfe0eb'},cpp,84,0,84
82d529e,{'file_name': '82d529e'},h,42,0,42
82867a3,{'file_name': '82867a3'},cpp,51,0,51
af6419b,{'file_name': 'af6419b'},h,10,1,11
b6b29b0,{'file_name': 'b6b29b0'},cpp,60,0,60
dc910fa,{'file_name': 'dc910fa'},h,27,0,27
6769a95,{'file_name': '6769a95'},cpp,55,0,55
3a1e8a6,{'file_name': '3a1e8a6'},h,121,0,121
95e2dbf,{'file_name': '95e2dbf'},cpp,62,0,62
65440eb,{'file_name': '65440eb'},h,24,0,24
fc6fb35,{'file_name': 'fc6fb35'},cpp,106,2,108
89165d2,{'file_name': '89165d2'},h,14,1,15
93c3775,{'file_name': '93c3775'},ui,22,4,26
b11e00c,{'file_name': 'b11e00c'},xml,5,0,5
7aa5422,{'file_name': '7aa5422'},svg,1,0,1
d1c20ac,{'file_name': 'd1c20ac'},svg,1,0,1
fb80bf3,{'file_name': 'fb80bf3'},qrc,3,0,3
390fdf4,{'file_name': '390fdf4'},png,0,0,0
e5ba75c,{'file_name': 'e5ba75c'},png,0,0,0
aa39670,{'file_name': 'aa39670'},png,0,0,0
b211dbf,{'file_name': 'b211dbf'},pro,9,0,9
9251d60,{'file_name': '9251d60'},cpp,2,0,2
bb11855,{'file_name': 'bb11855'},ui,14,11,25
be9edac,{'file_name': 'be9edac'},cpp,68,62,130
f33a9aa,{'file_name': 'f33a9aa'},h,9,210,219
cd419cd,{'file_name': 'cd419cd'},cpp,43,18,61
e2416ed,{'file_name': 'e2416ed'},h,2,1,3
328fcfa,{'file_name': '328fcfa'},cpp,32,7,39
5c18307,{'file_name': '5c18307'},h,4,0,4
e8ead9d,{'file_name': 'e8ead9d'},cpp,11,2,13
e7e6780,{'file_name': 'e7e6780'},h,15,0,15
46d746e,{'file_name': '46d746e'},h,1,0,1
38d10c7,{'file_name': '38d10c7'},h,20,7,27
c92caf1,{'file_name': 'c92caf1'},h,72,0,72
2e246f6,{'file_name': '2e246f6'},h,75,0,75
dae3c50,{'file_name': 'dae3c50'},cpp,8,0,8
ab32520,{'file_name': 'ab32520'},h,1,0,1
b2495a7,{'file_name': 'b2495a7'},cpp,115,0,115
8810760,{'file_name': '8810760'},h,17,0,17
5236239,{'file_name': '5236239'},h,1,0,1
4dce680,{'file_name': '4dce680'},cpp,44,0,44
6f2569f,{'file_name': '6f2569f'},h,30,0,30
ef87376,{'file_name': 'ef87376'},cpp,52,94,146
102971f,{'file_name': '102971f'},h,35,17,52
bc831b4,{'file_name': 'bc831b4'},cpp,166,20,186
96f08d2,{'file_name': '96f08d2'},h,96,10,106
abcba0f,{'file_name': 'abcba0f'},cpp,6,0,6
0eb183b,{'file_name': '0eb183b'},h,12,0,12
6afcd6a,{'file_name': '6afcd6a'},cpp,6,0,6
56faf13,{'file_name': '56faf13'},h,12,0,12
b30775f,{'file_name': 'b30775f'},cpp,18,0,18
2ef8f06,{'file_name': '2ef8f06'},h,23,0,23
a1e0c6f,{'file_name': 'a1e0c6f'},ui,30,0,30
6203afa,{'file_name': '6203afa'},cpp,0,0,0
3924ea5,{'file_name': '3924ea5'},h,1,1,2
b824eb4,{'file_name': 'b824eb4'},cpp,2,3,5
88f2d6d,{'file_name': '88f2d6d'},h,1,2,3
4ec1903,{'file_name': '4ec1903'},cpp,33,9,42
a677707,{'file_name': 'a677707'},h,3,3,6
cde5849,{'file_name': 'cde5849'},cpp,10,7,17
d62f0ca,{'file_name': 'd62f0ca'},h,1,1,2
cc7ea6c,{'file_name': 'cc7ea6c'},xml,6,0,6
f2802c0,{'file_name': 'f2802c0'},xml,4,0,4
e260c10,{'file_name': 'e260c10'},qrc,10,2,12
50a103a,{'file_name': '50a103a'},png,0,0,0
2fedfce,{'file_name': '2fedfce'},svg,2,0,2
386e34c,{'file_name': '386e34c'},qss,16,0,16
a368539,{'file_name': 'a368539'},svg,2,0,2
42b09eb,{'file_name': '42b09eb'},pro,28,13,41
bb38da4,{'file_name': 'bb38da4'},cpp,5,1,6
e4ebcc4,{'file_name': 'e4ebcc4'},cpp,20,4,24
049c0e7,{'file_name': '049c0e7'},h,2,2,4
5f495a4,{'file_name': '5f495a4'},h,10,0,10
7606c70,{'file_name': '7606c70'},cpp,91,15,106
1dd093f,{'file_name': '1dd093f'},h,43,26,69
23ce98e,{'file_name': '23ce98e'},cpp,38,26,64
539d3d0,{'file_name': '539d3d0'},h,6,3,9
e8276f9,{'file_name': 'e8276f9'},cpp,5,4,9
ee3d6fd,{'file_name': 'ee3d6fd'},h,5,5,10
b9d52cc,{'file_name': 'b9d52cc'},cpp,57,4,61
8237e09,{'file_name': '8237e09'},h,3,2,5
153067e,{'file_name': '153067e'},h,12,0,12
1e506c1,{'file_name': '1e506c1'},h,3,0,3
7c92b26,{'file_name': '7c92b26'},h,43,0,43
2e4d982,{'file_name': '2e4d982'},cpp,12,0,12
48658ba,{'file_name': '48658ba'},h,12,0,12
93c981c,{'file_name': '93c981c'},h,64,0,64
3eca2b0,{'file_name': '3eca2b0'},cpp,47,11,58
c8dc0e2,{'file_name': 'c8dc0e2'},h,33,0,33
1cac918,{'file_name': '1cac918'},cpp,38,0,38
faa65dd,{'file_name': 'faa65dd'},h,35,0,35
0c3e4c8,{'file_name': '0c3e4c8'},cpp,103,0,103
55a23dd,{'file_name': '55a23dd'},h,2,0,2
20817f7,{'file_name': '20817f7'},cpp,90,0,90
d01fa6d,{'file_name': 'd01fa6d'},h,47,0,47
d38bf2a,{'file_name': 'd38bf2a'},ui,31,0,31
8179cf1,{'file_name': '8179cf1'},qrc,11,0,11
2d6458c,{'file_name': '2d6458c'},png,0,0,0
5c874c3,{'file_name': '5c874c3'},qss,21,0,21
b6e7006,{'file_name': 'b6e7006'},svg,1,0,1
c4b641c,{'file_name': 'c4b641c'},cpp,288,0,288
b3645a7,{'file_name': 'b3645a7'},h,251,0,251
82b4dd4,{'file_name': '82b4dd4'},cpp,180,0,180
af19031,{'file_name': 'af19031'},h,40,0,40
bdc5fc2,{'file_name': 'bdc5fc2'},cpp,194,0,194
b070647,{'file_name': 'b070647'},h,51,0,51
6203afa,{'file_name': '6203afa'},cpp,38,0,38
8a4ff2c,{'file_name': '8a4ff2c'},h,25,0,25
485ac62,{'file_name': '485ac62'},cpp,54,0,54
47e5caf,{'file_name': '47e5caf'},h,26,0,26
c03dd63,{'file_name': 'c03dd63'},cpp,142,0,142
515868a,{'file_name': '515868a'},h,41,0,41
a83af58,{'file_name': 'a83af58'},cpp,0,192,192
fb200c6,{'file_name': 'fb200c6'},h,0,42,42
f1aa3aa,{'file_name': 'f1aa3aa'},cpp,0,67,67
a2c8752,{'file_name': 'a2c8752'},pro,30,7,37
416cd8c,{'file_name': '416cd8c'},h,0,27,27
16c398a,{'file_name': '16c398a'},cpp,10,3,13
d99e4b9,{'file_name': 'd99e4b9'},cpp,31,13,44
aac73a2,{'file_name': 'aac73a2'},h,10,3,13
2ac070a,{'file_name': '2ac070a'},ui,1,15,16
b1b4fc6,{'file_name': 'b1b4fc6'},cpp,2,11,13
3b1d1a3,{'file_name': '3b1d1a3'},h,0,1,1
22081a9,{'file_name': '22081a9'},cpp,19,11,30
a11ba2e,{'file_name': 'a11ba2e'},h,2,3,5
8c56557,{'file_name': '8c56557'},h,28,0,28
c056bd4,{'file_name': 'c056bd4'},cpp,13,0,13
c995580,{'file_name': 'c995580'},h,15,0,15
a83af58,{'file_name': 'a83af58'},cpp,136,22,158
fb200c6,{'file_name': 'fb200c6'},h,14,0,14
f1aa3aa,{'file_name': 'f1aa3aa'},cpp,10,2,12
50bb0ca,{'file_name': '50bb0ca'},pro,5,0,5
393eb55,{'file_name': '393eb55'},cpp,120,0,120
416cd8c,{'file_name': '416cd8c'},h,27,0,27
b68dadb,{'file_name': 'b68dadb'},cpp,2,0,2
8d9e03d,{'file_name': '8d9e03d'},cpp,7,1,8
f703da6,{'file_name': 'f703da6'},h,3,1,4
433129b,{'file_name': '433129b'},ui,4,1,5
4da94b8,{'file_name': '4da94b8'},cpp,1,1,2
87b9147,{'file_name': '87b9147'},cpp,61,8,69
151ed6d,{'file_name': '151ed6d'},h,12,7,19
3021ddd,{'file_name': '3021ddd'},ui,6,20,26
0b48d3b,{'file_name': '0b48d3b'},h,4,2,6
f288702,{'file_name': 'f288702'},LICENSE,674,0,674
4d82418,{'file_name': '4d82418'},md,0,111,111
4d82418,{'file_name': '4d82418'},md,111,0,111
4d82418,{'file_name': '4d82418'},md,111,0,111
9cb1d16,{'file_name': '9cb1d16'},h,2,1,3
d07d621,{'file_name': 'd07d621'},cpp,1,1,2
e4bbf08,{'file_name': 'e4bbf08'},h,39,0,39
8426e44,{'file_name': '8426e44'},cpp,2,0,2
482bd6a,{'file_name': '482bd6a'},h,1,0,1
1d0438b,{'file_name': '1d0438b'},cpp,28,11,39
1718cd3,{'file_name': '1718cd3'},h,9,1,10
6a4f7bd,{'file_name': '6a4f7bd'},cpp,10,2,12
a76c8eb,{'file_name': 'a76c8eb'},h,11,1,12
75a53e4,{'file_name': '75a53e4'},cpp,7,1,8
884a816,{'file_name': '884a816'},cpp,72,8,80
ff0d0a4,{'file_name': 'ff0d0a4'},h,6,0,6
2f7bb58,{'file_name': '2f7bb58'},cpp,10,1,11
c970163,{'file_name': 'c970163'},h,1,0,1
15bb5c9,{'file_name': '15bb5c9'},h,1,1,2
ee56257,{'file_name': 'ee56257'},h,1,1,2
56d7d47,{'file_name': '56d7d47'},cpp,136,0,136
51dfc83,{'file_name': '51dfc83'},h,21,0,21
2a6223b,{'file_name': '2a6223b'},cpp,14,12,26
4666909,{'file_name': '4666909'},h,1,1,2
b384796,{'file_name': 'b384796'},cpp,2,1,3
0c4f176,{'file_name': '0c4f176'},h,1,1,2
268ab74,{'file_name': '268ab74'},cpp,16,15,31
9f43264,{'file_name': '9f43264'},cpp,24,6,30
5998f8b,{'file_name': '5998f8b'},h,2,2,4
f7728fb,{'file_name': 'f7728fb'},cpp,86,34,120
726f8ed,{'file_name': '726f8ed'},h,1,0,1
43dcab1,{'file_name': '43dcab1'},cpp,5,2,7
eeae210,{'file_name': 'eeae210'},h,1,1,2
929cb63,{'file_name': '929cb63'},cpp,37,0,37
244c1a5,{'file_name': '244c1a5'},h,21,0,21
98e6214,{'file_name': '98e6214'},cpp,34,58,92
6139fd2,{'file_name': '6139fd2'},h,4,0,4
30f0a2d,{'file_name': '30f0a2d'},cpp,92,1,93
3392bc8,{'file_name': '3392bc8'},h,3,2,5
048ea50,{'file_name': '048ea50'},xml,11,0,11
addff7e,{'file_name': 'addff7e'},json,24,0,24
a3166de,{'file_name': 'a3166de'},xml,22,0,22
ab45049,{'file_name': 'ab45049'},qrc,7,4,11
6ec9256,{'file_name': '6ec9256'},png,0,0,0
c22d0ae,{'file_name': 'c22d0ae'},cpp,3,2,5
a9b4f4a,{'file_name': 'a9b4f4a'},pro,7,0,7
c6f1756,{'file_name': 'c6f1756'},cpp,4,1,5
6b703bd,{'file_name': '6b703bd'},cpp,25,17,42
c36464c,{'file_name': 'c36464c'},h,1,0,1
ea6a364,{'file_name': 'ea6a364'},cpp,0,2,2
590bfe5,{'file_name': '590bfe5'},cpp,5,1,6
cff4743,{'file_name': 'cff4743'},json,0,9,9
cff4743,{'file_name': 'cff4743'},json,9,0,9
344332c,{'file_name': '344332c'},h,1,1,2
b7e0f8f,{'file_name': 'b7e0f8f'},h,17,1,18
1534014,{'file_name': '1534014'},h,62,4,66
7a77f77,{'file_name': '7a77f77'},cpp,82,0,82
2bd5d7f,{'file_name': '2bd5d7f'},h,45,0,45
2eaf04d,{'file_name': '2eaf04d'},cpp,93,0,93
1f636ef,{'file_name': '1f636ef'},h,15,0,15
e5ae7fc,{'file_name': 'e5ae7fc'},h,10,0,10
9a422fe,{'file_name': '9a422fe'},cpp,33,4,37
aaf5df2,{'file_name': 'aaf5df2'},h,8,1,9
219ee87,{'file_name': '219ee87'},cpp,290,3,293
18b074a,{'file_name': '18b074a'},h,28,8,36
da2e9e8,{'file_name': 'da2e9e8'},cpp,94,0,94
d6f3e20,{'file_name': 'd6f3e20'},h,34,0,34
f3cde10,{'file_name': 'f3cde10'},cpp,4,0,4
805a98c,{'file_name': '805a98c'},h,5,2,7
9b8ae3e,{'file_name': '9b8ae3e'},cpp,84,0,84
6dec96b,{'file_name': '6dec96b'},h,30,0,30
ff2a773,{'file_name': 'ff2a773'},cpp,57,16,73
c105e73,{'file_name': 'c105e73'},h,2,0,2
7f82d93,{'file_name': '7f82d93'},cpp,8,3,11
c3c800a,{'file_name': 'c3c800a'},h,5,4,9
ba59158,{'file_name': 'ba59158'},cpp,76,107,183
0cce4a7,{'file_name': '0cce4a7'},h,9,10,19
3eac905,{'file_name': '3eac905'},cpp,91,0,91
00b2f43,{'file_name': '00b2f43'},h,31,0,31
19242dc,{'file_name': '19242dc'},cpp,24,5,29
61b4d9a,{'file_name': '61b4d9a'},h,1,2,3
e5cdc71,{'file_name': 'e5cdc71'},cpp,27,2,29
3c2a6b9,{'file_name': '3c2a6b9'},h,2,0,2
06eac23,{'file_name': '06eac23'},pro,20,2,22
1a8efc0,{'file_name': '1a8efc0'},cpp,8,3,11
833213b,{'file_name': '833213b'},h,2,2,4
1e2d3e2,{'file_name': '1e2d3e2'},cpp,7,1,8
24d9716,{'file_name': '24d9716'},cpp,45,1,46
553dada,{'file_name': '553dada'},h,5,2,7
db6b9e4,{'file_name': 'db6b9e4'},cpp,10,6,16
e2fc7d2,{'file_name': 'e2fc7d2'},cpp,4,3,7
1702601,{'file_name': '1702601'},h,2,1,3
27a0310,{'file_name': '27a0310'},cpp,85,11,96
cf5effc,{'file_name': 'cf5effc'},h,1,0,1
fb662d5,{'file_name': 'fb662d5'},cpp,8,3,11
833213b,{'file_name': '833213b'},h,2,2,4
d8d5851,{'file_name': 'd8d5851'},cpp,77,31,108
be530bc,{'file_name': 'be530bc'},h,2,0,2
fa8d4cf,{'file_name': 'fa8d4cf'},h,1,0,1
c056bd4,{'file_name': 'c056bd4'},cpp,0,13,13
c995580,{'file_name': 'c995580'},h,0,15,15
3ab6bb4,{'file_name': '3ab6bb4'},pro,30,0,30
ec7a50f,{'file_name': 'ec7a50f'},h,12,0,12
e807b5f,{'file_name': 'e807b5f'},cpp,6,1,7
7f0b088,{'file_name': '7f0b088'},h,8,1,9
c53ae55,{'file_name': 'c53ae55'},cpp,30,0,30
7665ad9,{'file_name': '7665ad9'},h,3,0,3
a917d12,{'file_name': 'a917d12'},h,7,1,8
251b416,{'file_name': '251b416'},cpp,130,0,130
d9ce551,{'file_name': 'd9ce551'},h,35,0,35
7324619,{'file_name': '7324619'},cpp,52,23,75
1a2a066,{'file_name': '1a2a066'},h,4,0,4
af05824,{'file_name': 'af05824'},cpp,116,1,117
c627956,{'file_name': 'c627956'},h,5,0,5
f99cf06,{'file_name': 'f99cf06'},cpp,96,35,131
c0fc225,{'file_name': 'c0fc225'},h,12,6,18
64a974a,{'file_name': '64a974a'},cpp,6,1,7
54c2f32,{'file_name': '54c2f32'},h,1,0,1
4b0e07a,{'file_name': '4b0e07a'},cpp,49,2,51
70cae5d,{'file_name': '70cae5d'},h,1,0,1
463ae52,{'file_name': '463ae52'},cpp,0,1,1
e77528f,{'file_name': 'e77528f'},xml,6,0,6
516272b,{'file_name': '516272b'},qrc,3,0,3
2d0a2c1,{'file_name': '2d0a2c1'},png,0,0,0
c738d2a,{'file_name': 'c738d2a'},qss,8,10,18
ad329bb,{'file_name': 'ad329bb'},svg,2,0,2
67d6bbf,{'file_name': '67d6bbf'},png,0,0,0
a9d8f8e,{'file_name': 'a9d8f8e'},cpp,33,0,33
65e21b5,{'file_name': '65e21b5'},h,12,0,12
64dab33,{'file_name': '64dab33'},pro,11,2,13
4ea3655,{'file_name': '4ea3655'},cpp,163,0,163
92d2561,{'file_name': '92d2561'},h,53,0,53
d973c5d,{'file_name': 'd973c5d'},cpp,1,1,2
ab5cc46,{'file_name': 'ab5cc46'},cpp,33,1,34
1971d0a,{'file_name': '1971d0a'},cpp,0,1,1
f8d6951,{'file_name': 'f8d6951'},h,0,1,1
681cd85,{'file_name': '681cd85'},cpp,1,2,3
640a918,{'file_name': '640a918'},h,1,1,2
ee466f7,{'file_name': 'ee466f7'},cpp,22,1,23
a038598,{'file_name': 'a038598'},h,4,0,4
3aa829d,{'file_name': '3aa829d'},cpp,82,4,86
73eadb0,{'file_name': '73eadb0'},h,2,1,3
4ea3655,{'file_name': '4ea3655'},cpp,8,18,26
92d2561,{'file_name': '92d2561'},h,1,1,2
8f6ed6a,{'file_name': '8f6ed6a'},cpp,4,0,4
3b33da5,{'file_name': '3b33da5'},h,1,1,2
fab7372,{'file_name': 'fab7372'},gitignore,73,0,73
3ab6bb4,{'file_name': '3ab6bb4'},pro,30,0,30
ec7a50f,{'file_name': 'ec7a50f'},h,12,0,12
79299d5,{'file_name': '79299d5'},cpp,169,0,169
21cd320,{'file_name': '21cd320'},h,53,0,53
680a6f8,{'file_name': '680a6f8'},h,3,2,5
27620a3,{'file_name': '27620a3'},h,12,0,12
1b0f290,{'file_name': '1b0f290'},cpp,3,1,4
da62fea,{'file_name': 'da62fea'},h,3,1,4
3d58480,{'file_name': '3d58480'},cpp,65,24,89
31de85e,{'file_name': '31de85e'},h,13,1,14
b7d1ef3,{'file_name': 'b7d1ef3'},h,15,0,15
191cd83,{'file_name': '191cd83'},h,19,0,19
cbf76d0,{'file_name': 'cbf76d0'},h,11,1,12
1874664,{'file_name': '1874664'},h,14,0,14
efb898a,{'file_name': 'efb898a'},cpp,62,0,62
c9f6bda,{'file_name': 'c9f6bda'},h,23,0,23
3523d12,{'file_name': '3523d12'},cpp,113,0,113
bb29ca0,{'file_name': 'bb29ca0'},h,22,0,22
d632007,{'file_name': 'd632007'},cpp,228,0,228
aeef848,{'file_name': 'aeef848'},h,25,0,25
6dc6f98,{'file_name': '6dc6f98'},cpp,121,36,157
0b2a093,{'file_name': '0b2a093'},h,15,4,19
8f8e0b2,{'file_name': '8f8e0b2'},cpp,71,15,86
cdfb03c,{'file_name': 'cdfb03c'},h,10,7,17
cbd8938,{'file_name': 'cbd8938'},cpp,115,22,137
909b274,{'file_name': '909b274'},h,12,1,13
1151a27,{'file_name': '1151a27'},cpp,92,15,107
ae0df28,{'file_name': 'ae0df28'},h,26,3,29
6769a95,{'file_name': '6769a95'},cpp,0,55,55
e76ced5,{'file_name': 'e76ced5'},cpp,66,0,66
765210f,{'file_name': '765210f'},h,26,9,35
935ec44,{'file_name': '935ec44'},cpp,42,3,45
0a19953,{'file_name': '0a19953'},h,6,0,6
bbebf5e,{'file_name': 'bbebf5e'},cpp,218,10,228
572dca5,{'file_name': '572dca5'},h,15,1,16
fea6a5e,{'file_name': 'fea6a5e'},cpp,2,1,3
242722c,{'file_name': '242722c'},h,1,1,2
7aa5422,{'file_name': '7aa5422'},svg,0,1,1
d1c20ac,{'file_name': 'd1c20ac'},svg,0,1,1
b25193a,{'file_name': 'b25193a'},qrc,12,0,12
2edd26d,{'file_name': '2edd26d'},svg,2,0,2
11d073b,{'file_name': '11d073b'},svg,2,0,2
cd16c4f,{'file_name': 'cd16c4f'},png,0,0,0
9bf0e17,{'file_name': '9bf0e17'},png,0,0,0
fca7ee9,{'file_name': 'fca7ee9'},png,0,0,0
83ee128,{'file_name': '83ee128'},png,0,0,0
08fbf48,{'file_name': '08fbf48'},png,0,0,0
d2712da,{'file_name': 'd2712da'},png,0,0,0
4d6b7ca,{'file_name': '4d6b7ca'},png,0,0,0
e19a42c,{'file_name': 'e19a42c'},png,0,0,0
62c5b3a,{'file_name': '62c5b3a'},png,0,0,0
eaa4661,{'file_name': 'eaa4661'},cpp,91,0,91
8a4ecfd,{'file_name': '8a4ecfd'},h,32,0,32
f828c5f,{'file_name': 'f828c5f'},pro,13,2,15
9b17fcf,{'file_name': '9b17fcf'},cpp,1,1,2
7d63e29,{'file_name': '7d63e29'},cpp,12,0,12
aad4cdf,{'file_name': 'aad4cdf'},h,3,0,3
fda1b09,{'file_name': 'fda1b09'},h,2,0,2
cbf8310,{'file_name': 'cbf8310'},cpp,9,6,15
aabb55b,{'file_name': 'aabb55b'},cpp,7,0,7
f9c5e5b,{'file_name': 'f9c5e5b'},h,3,2,5
0c58f90,{'file_name': '0c58f90'},cpp,17,2,19
9ffcad1,{'file_name': '9ffcad1'},h,2,2,4
613a097,{'file_name': '613a097'},h,11,0,11
5515d11,{'file_name': '5515d11'},h,1,0,1
770df82,{'file_name': '770df82'},h,3,0,3
8bbfec5,{'file_name': '8bbfec5'},h,4,0,4
2093464,{'file_name': '2093464'},cpp,5,0,5
2745186,{'file_name': '2745186'},h,1,0,1
a181ce5,{'file_name': 'a181ce5'},h,18,0,18
18af7ee,{'file_name': '18af7ee'},cpp,143,0,143
4c0827b,{'file_name': '4c0827b'},h,29,2,31
ddfe0eb,{'file_name': 'ddfe0eb'},cpp,84,0,84
82d529e,{'file_name': '82d529e'},h,42,0,42
82867a3,{'file_name': '82867a3'},cpp,51,0,51
af6419b,{'file_name': 'af6419b'},h,10,1,11
b6b29b0,{'file_name': 'b6b29b0'},cpp,60,0,60
dc910fa,{'file_name': 'dc910fa'},h,27,0,27
6769a95,{'file_name': '6769a95'},cpp,55,0,55
3a1e8a6,{'file_name': '3a1e8a6'},h,121,0,121
95e2dbf,{'file_name': '95e2dbf'},cpp,62,0,62
65440eb,{'file_name': '65440eb'},h,24,0,24
fc6fb35,{'file_name': 'fc6fb35'},cpp,106,2,108
89165d2,{'file_name': '89165d2'},h,14,1,15
93c3775,{'file_name': '93c3775'},ui,22,4,26
b11e00c,{'file_name': 'b11e00c'},xml,5,0,5
7aa5422,{'file_name': '7aa5422'},svg,1,0,1
d1c20ac,{'file_name': 'd1c20ac'},svg,1,0,1
fb80bf3,{'file_name': 'fb80bf3'},qrc,3,0,3
390fdf4,{'file_name': '390fdf4'},png,0,0,0
e5ba75c,{'file_name': 'e5ba75c'},png,0,0,0
aa39670,{'file_name': 'aa39670'},png,0,0,0
b211dbf,{'file_name': 'b211dbf'},pro,9,0,9
9251d60,{'file_name': '9251d60'},cpp,2,0,2
bb11855,{'file_name': 'bb11855'},ui,14,11,25
be9edac,{'file_name': 'be9edac'},cpp,68,62,130
f33a9aa,{'file_name': 'f33a9aa'},h,9,210,219
cd419cd,{'file_name': 'cd419cd'},cpp,43,18,61
e2416ed,{'file_name': 'e2416ed'},h,2,1,3
328fcfa,{'file_name': '328fcfa'},cpp,32,7,39
5c18307,{'file_name': '5c18307'},h,4,0,4
e8ead9d,{'file_name': 'e8ead9d'},cpp,11,2,13
e7e6780,{'file_name': 'e7e6780'},h,15,0,15
46d746e,{'file_name': '46d746e'},h,1,0,1
38d10c7,{'file_name': '38d10c7'},h,20,7,27
c92caf1,{'file_name': 'c92caf1'},h,72,0,72
2e246f6,{'file_name': '2e246f6'},h,75,0,75
dae3c50,{'file_name': 'dae3c50'},cpp,8,0,8
ab32520,{'file_name': 'ab32520'},h,1,0,1
b2495a7,{'file_name': 'b2495a7'},cpp,115,0,115
8810760,{'file_name': '8810760'},h,17,0,17
5236239,{'file_name': '5236239'},h,1,0,1
4dce680,{'file_name': '4dce680'},cpp,44,0,44
6f2569f,{'file_name': '6f2569f'},h,30,0,30
ef87376,{'file_name': 'ef87376'},cpp,52,94,146
102971f,{'file_name': '102971f'},h,35,17,52
bc831b4,{'file_name': 'bc831b4'},cpp,166,20,186
96f08d2,{'file_name': '96f08d2'},h,96,10,106
abcba0f,{'file_name': 'abcba0f'},cpp,6,0,6
0eb183b,{'file_name': '0eb183b'},h,12,0,12
6afcd6a,{'file_name': '6afcd6a'},cpp,6,0,6
56faf13,{'file_name': '56faf13'},h,12,0,12
b30775f,{'file_name': 'b30775f'},cpp,18,0,18
2ef8f06,{'file_name': '2ef8f06'},h,23,0,23
a1e0c6f,{'file_name': 'a1e0c6f'},ui,30,0,30
6203afa,{'file_name': '6203afa'},cpp,0,0,0
3924ea5,{'file_name': '3924ea5'},h,1,1,2
b824eb4,{'file_name': 'b824eb4'},cpp,2,3,5
88f2d6d,{'file_name': '88f2d6d'},h,1,2,3
4ec1903,{'file_name': '4ec1903'},cpp,33,9,42
a677707,{'file_name': 'a677707'},h,3,3,6
cde5849,{'file_name': 'cde5849'},cpp,10,7,17
d62f0ca,{'file_name': 'd62f0ca'},h,1,1,2
cc7ea6c,{'file_name': 'cc7ea6c'},xml,6,0,6
f2802c0,{'file_name': 'f2802c0'},xml,4,0,4
e260c10,{'file_name': 'e260c10'},qrc,10,2,12
50a103a,{'file_name': '50a103a'},png,0,0,0
2fedfce,{'file_name': '2fedfce'},svg,2,0,2
386e34c,{'file_name': '386e34c'},qss,16,0,16
a368539,{'file_name': 'a368539'},svg,2,0,2
42b09eb,{'file_name': '42b09eb'},pro,28,13,41
bb38da4,{'file_name': 'bb38da4'},cpp,5,1,6
e4ebcc4,{'file_name': 'e4ebcc4'},cpp,20,4,24
049c0e7,{'file_name': '049c0e7'},h,2,2,4
5f495a4,{'file_name': '5f495a4'},h,10,0,10
7606c70,{'file_name': '7606c70'},cpp,91,15,106
1dd093f,{'file_name': '1dd093f'},h,43,26,69
23ce98e,{'file_name': '23ce98e'},cpp,38,26,64
539d3d0,{'file_name': '539d3d0'},h,6,3,9
e8276f9,{'file_name': 'e8276f9'},cpp,5,4,9
ee3d6fd,{'file_name': 'ee3d6fd'},h,5,5,10
b9d52cc,{'file_name': 'b9d52cc'},cpp,57,4,61
8237e09,{'file_name': '8237e09'},h,3,2,5
153067e,{'file_name': '153067e'},h,12,0,12
1e506c1,{'file_name': '1e506c1'},h,3,0,3
7c92b26,{'file_name': '7c92b26'},h,43,0,43
2e4d982,{'file_name': '2e4d982'},cpp,12,0,12
48658ba,{'file_name': '48658ba'},h,12,0,12
93c981c,{'file_name': '93c981c'},h,64,0,64
3eca2b0,{'file_name': '3eca2b0'},cpp,47,11,58
c8dc0e2,{'file_name': 'c8dc0e2'},h,33,0,33
1cac918,{'file_name': '1cac918'},cpp,38,0,38
faa65dd,{'file_name': 'faa65dd'},h,35,0,35
0c3e4c8,{'file_name': '0c3e4c8'},cpp,103,0,103
55a23dd,{'file_name': '55a23dd'},h,2,0,2
20817f7,{'file_name': '20817f7'},cpp,90,0,90
d01fa6d,{'file_name': 'd01fa6d'},h,47,0,47
d38bf2a,{'file_name': 'd38bf2a'},ui,31,0,31
8179cf1,{'file_name': '8179cf1'},qrc,11,0,11
2d6458c,{'file_name': '2d6458c'},png,0,0,0
5c874c3,{'file_name': '5c874c3'},qss,21,0,21
b6e7006,{'file_name': 'b6e7006'},svg,1,0,1
c4b641c,{'file_name': 'c4b641c'},cpp,288,0,288
b3645a7,{'file_name': 'b3645a7'},h,251,0,251
82b4dd4,{'file_name': '82b4dd4'},cpp,180,0,180
af19031,{'file_name': 'af19031'},h,40,0,40
bdc5fc2,{'file_name': 'bdc5fc2'},cpp,194,0,194
b070647,{'file_name': 'b070647'},h,51,0,51
6203afa,{'file_name': '6203afa'},cpp,38,0,38
8a4ff2c,{'file_name': '8a4ff2c'},h,25,0,25
485ac62,{'file_name': '485ac62'},cpp,54,0,54
47e5caf,{'file_name': '47e5caf'},h,26,0,26
c03dd63,{'file_name': 'c03dd63'},cpp,142,0,142
515868a,{'file_name': '515868a'},h,41,0,41
a83af58,{'file_name': 'a83af58'},cpp,0,192,192
fb200c6,{'file_name': 'fb200c6'},h,0,42,42
f1aa3aa,{'file_name': 'f1aa3aa'},cpp,0,67,67
a2c8752,{'file_name': 'a2c8752'},pro,30,7,37
416cd8c,{'file_name': '416cd8c'},h,0,27,27
16c398a,{'file_name': '16c398a'},cpp,10,3,13
d99e4b9,{'file_name': 'd99e4b9'},cpp,31,13,44
aac73a2,{'file_name': 'aac73a2'},h,10,3,13
2ac070a,{'file_name': '2ac070a'},ui,1,15,16
b1b4fc6,{'file_name': 'b1b4fc6'},cpp,2,11,13
3b1d1a3,{'file_name': '3b1d1a3'},h,0,1,1
22081a9,{'file_name': '22081a9'},cpp,19,11,30
a11ba2e,{'file_name': 'a11ba2e'},h,2,3,5
8c56557,{'file_name': '8c56557'},h,28,0,28
c056bd4,{'file_name': 'c056bd4'},cpp,13,0,13
c995580,{'file_name': 'c995580'},h,15,0,15
a83af58,{'file_name': 'a83af58'},cpp,136,22,158
fb200c6,{'file_name': 'fb200c6'},h,14,0,14
f1aa3aa,{'file_name': 'f1aa3aa'},cpp,10,2,12
50bb0ca,{'file_name': '50bb0ca'},pro,5,0,5
393eb55,{'file_name': '393eb55'},cpp,120,0,120
416cd8c,{'file_name': '416cd8c'},h,27,0,27
b68dadb,{'file_name': 'b68dadb'},cpp,2,0,2
8d9e03d,{'file_name': '8d9e03d'},cpp,7,1,8
f703da6,{'file_name': 'f703da6'},h,3,1,4
433129b,{'file_name': '433129b'},ui,4,1,5
4da94b8,{'file_name': '4da94b8'},cpp,1,1,2
87b9147,{'file_name': '87b9147'},cpp,61,8,69
151ed6d,{'file_name': '151ed6d'},h,12,7,19
3021ddd,{'file_name': '3021ddd'},ui,6,20,26
0b48d3b,{'file_name': '0b48d3b'},h,4,2,6
3e6c952,{'file_name': '3e6c952'},cpp,78,0,78
935b0ef,{'file_name': '935b0ef'},h,28,0,28
0c0af73,{'file_name': '0c0af73'},cpp,59,0,59
8b9f924,{'file_name': '8b9f924'},h,0,19,19
aca46a4,{'file_name': 'aca46a4'},cpp,0,18,18
c78ad94,{'file_name': 'c78ad94'},pro,12,5,17
f90baf9,{'file_name': 'f90baf9'},cpp,6,2,8
493d8e3,{'file_name': '493d8e3'},ui,2,3,5
cdcad08,{'file_name': 'cdcad08'},cpp,28,0,28
7b8688f,{'file_name': '7b8688f'},h,22,0,22
9bd3c79,{'file_name': '9bd3c79'},cpp,64,0,64
813538f,{'file_name': '813538f'},h,34,0,34
0c86122,{'file_name': '0c86122'},ui,52,0,52
6f010af,{'file_name': '6f010af'},h,24,0,24
8b9f924,{'file_name': '8b9f924'},h,19,0,19
aca46a4,{'file_name': 'aca46a4'},cpp,18,0,18
e9d0e90,{'file_name': 'e9d0e90'},pro,2,0,2
ce6d3c0,{'file_name': 'ce6d3c0'},cpp,1,0,1
f4c30ba,{'file_name': 'f4c30ba'},cpp,9,0,9
6c298c4,{'file_name': '6c298c4'},h,4,0,4
4aa8b89,{'file_name': '4aa8b89'},ui,27,4,31
fab7372,{'file_name': 'fab7372'},gitignore,73,0,73
98774eb,{'file_name': '98774eb'},pro,34,0,34
e23892e,{'file_name': 'e23892e'},ts,3,0,3
fd3e533,{'file_name': 'fd3e533'},cpp,11,0,11
41a26bd,{'file_name': '41a26bd'},cpp,15,0,15
4643e32,{'file_name': '4643e32'},h,21,0,21
b232854,{'file_name': 'b232854'},ui,22,0,22
5f8b228,{'file_name': '5f8b228'},md,1,0,1
fb662d5,{'file_name': 'fb662d5'},cpp,8,3,11
833213b,{'file_name': '833213b'},h,2,2,4
4ea3655,{'file_name': '4ea3655'},cpp,8,18,26
92d2561,{'file_name': '92d2561'},h,1,1,2
8f6ed6a,{'file_name': '8f6ed6a'},cpp,4,0,4
3b33da5,{'file_name': '3b33da5'},h,1,1,2
fab7372,{'file_name': 'fab7372'},gitignore,73,0,73
3ab6bb4,{'file_name': '3ab6bb4'},pro,30,0,30
ec7a50f,{'file_name': 'ec7a50f'},h,12,0,12
79299d5,{'file_name': '79299d5'},cpp,169,0,169
21cd320,{'file_name': '21cd320'},h,53,0,53
e5130c2,{'file_name': 'e5130c2'},py,1,1,2
7670866,{'file_name': '7670866'},py,39,0,39
eef4d90,{'file_name': 'eef4d90'},py,260,0,260
78e486c,{'file_name': '78e486c'},rst,2,12,14
f8eaa99,{'file_name': 'f8eaa99'},pickle,0,0,0
a0fc0ec,{'file_name': 'a0fc0ec'},doctree,0,0,0
8f924d0,{'file_name': '8f924d0'},doctree,0,0,0
43cdf77,{'file_name': '43cdf77'},txt,1,1,2
25ce672,{'file_name': '25ce672'},txt,18,9,27
7d21a94,{'file_name': '7d21a94'},html,1,1,2
8ba9a7f,{'file_name': '8ba9a7f'},html,23,8,31
d123b40,{'file_name': 'd123b40'},js,1,1,2
43cdf77,{'file_name': '43cdf77'},rst,1,1,2
25ce672,{'file_name': '25ce672'},rst,18,9,27
048fa25,{'file_name': '048fa25'},code-workspace,1,0,1
3fc2645,{'file_name': '3fc2645'},pickle,0,0,0
0872c87,{'file_name': '0872c87'},doctree,0,0,0
fe650b0,{'file_name': 'fe650b0'},doctree,0,0,0
8256a5a,{'file_name': '8256a5a'},doctree,0,0,0
cef1c96,{'file_name': 'cef1c96'},txt,18,11,29
094996d,{'file_name': '094996d'},txt,57,0,57
a10fe4c,{'file_name': 'a10fe4c'},txt,1,1,2
d7f594d,{'file_name': 'd7f594d'},inv,0,0,0
48b977b,{'file_name': '48b977b'},html,39,11,50
64f15b7,{'file_name': '64f15b7'},html,335,0,335
6262f66,{'file_name': '6262f66'},html,0,1,1
b0fe332,{'file_name': 'b0fe332'},html,2,2,4
b3cfdf9,{'file_name': 'b3cfdf9'},js,1,1,2
094996d,{'file_name': '094996d'},rst,57,0,57
5a17ab5,{'file_name': '5a17ab5'},rst,0,10,10
a10fe4c,{'file_name': 'a10fe4c'},rst,1,1,2
cef1c96,{'file_name': 'cef1c96'},rst,18,11,29
fa21c09,{'file_name': 'fa21c09'},pickle,0,0,0
f543d67,{'file_name': 'f543d67'},doctree,0,0,0
2f96da1,{'file_name': '2f96da1'},doctree,0,0,0
3a6b3f5,{'file_name': '3a6b3f5'},txt,3,0,3
67b0b36,{'file_name': '67b0b36'},txt,51,3,54
abc126e,{'file_name': 'abc126e'},html,4,0,4
cb45abf,{'file_name': 'cb45abf'},html,80,5,85
ae50601,{'file_name': 'ae50601'},js,1,1,2
67b0b36,{'file_name': '67b0b36'},rst,51,3,54
3a6b3f5,{'file_name': '3a6b3f5'},rst,3,0,3
7921bf8,{'file_name': '7921bf8'},code-workspace,4,1,5
b83078f,{'file_name': 'b83078f'},pickle,0,0,0
6224fba,{'file_name': '6224fba'},doctree,0,0,0
c7cec5c,{'file_name': 'c7cec5c'},doctree,0,0,0
747ae00,{'file_name': '747ae00'},doctree,0,0,0
c504e4c,{'file_name': 'c504e4c'},txt,3,3,6
69fa091,{'file_name': '69fa091'},txt,47,3,50
6dcaf84,{'file_name': '6dcaf84'},txt,8,8,16
529b149,{'file_name': '529b149'},html,3,3,6
194b969,{'file_name': '194b969'},html,74,5,79
93b294d,{'file_name': '93b294d'},html,10,10,20
98d2590,{'file_name': '98d2590'},js,1,1,2
69fa091,{'file_name': '69fa091'},rst,47,3,50
6dcaf84,{'file_name': '6dcaf84'},rst,8,8,16
c504e4c,{'file_name': 'c504e4c'},rst,3,3,6
1d5a034,{'file_name': '1d5a034'},pickle,0,0,0
8791887,{'file_name': '8791887'},doctree,0,0,0
b89d371,{'file_name': 'b89d371'},doctree,0,0,0
e38d73c,{'file_name': 'e38d73c'},doctree,0,0,0
fe9d657,{'file_name': 'fe9d657'},txt,6,0,6
193da45,{'file_name': '193da45'},txt,38,3,41
4b5dc25,{'file_name': '4b5dc25'},txt,1,0,1
b760f26,{'file_name': 'b760f26'},html,7,1,8
979184d,{'file_name': '979184d'},html,67,5,72
833a2b4,{'file_name': '833a2b4'},html,1,0,1
036d17c,{'file_name': '036d17c'},js,1,1,2
193da45,{'file_name': '193da45'},rst,38,3,41
fe9d657,{'file_name': 'fe9d657'},rst,6,0,6
4b5dc25,{'file_name': '4b5dc25'},rst,1,0,1
848feb8,{'file_name': '848feb8'},pickle,0,0,0
baa1b2c,{'file_name': 'baa1b2c'},doctree,0,0,0
1bbb8b1,{'file_name': '1bbb8b1'},doctree,0,0,0
481121b,{'file_name': '481121b'},doctree,0,0,0
c416a5d,{'file_name': 'c416a5d'},doctree,0,0,0
497722b,{'file_name': '497722b'},doctree,0,0,0
abe46ec,{'file_name': 'abe46ec'},doctree,0,0,0
474d199,{'file_name': '474d199'},doctree,0,0,0
bd5683c,{'file_name': 'bd5683c'},txt,36,0,36
f43144f,{'file_name': 'f43144f'},txt,2,1,3
b483bc3,{'file_name': 'b483bc3'},txt,15,0,15
5f9cd9b,{'file_name': '5f9cd9b'},txt,13,3,16
feac771,{'file_name': 'feac771'},txt,5,3,8
e4740b0,{'file_name': 'e4740b0'},txt,19,3,22
df0cd8a,{'file_name': 'df0cd8a'},txt,1,1,2
25654c6,{'file_name': '25654c6'},inv,0,0,0
1dc7ee6,{'file_name': '1dc7ee6'},html,259,0,259
a44516d,{'file_name': 'a44516d'},html,1,0,1
b7a9240,{'file_name': 'b7a9240'},html,245,0,245
72d9934,{'file_name': '72d9934'},html,14,6,20
b26da38,{'file_name': 'b26da38'},html,6,4,10
1d4cca1,{'file_name': '1d4cca1'},html,27,6,33
c321c8e,{'file_name': 'c321c8e'},html,2,2,4
0c0b2ed,{'file_name': '0c0b2ed'},js,1,1,2
b483bc3,{'file_name': 'b483bc3'},rst,15,0,15
5f9cd9b,{'file_name': '5f9cd9b'},rst,13,3,16
feac771,{'file_name': 'feac771'},rst,5,3,8
e4740b0,{'file_name': 'e4740b0'},rst,19,3,22
df0cd8a,{'file_name': 'df0cd8a'},rst,1,0,1
f43144f,{'file_name': 'f43144f'},rst,2,1,3
bd5683c,{'file_name': 'bd5683c'},rst,36,0,36
0bbf11c,{'file_name': '0bbf11c'},buildinfo,0,4,4
46d5905,{'file_name': '46d5905'},pickle,0,0,0
dfd39c4,{'file_name': 'dfd39c4'},doctree,0,0,0
eb71731,{'file_name': 'eb71731'},doctree,0,0,0
3698e9f,{'file_name': '3698e9f'},doctree,0,0,0
0d64f6a,{'file_name': '0d64f6a'},doctree,0,0,0
6a4e924,{'file_name': '6a4e924'},doctree,0,0,0
0413361,{'file_name': '0413361'},doctree,0,0,0
c521ab1,{'file_name': 'c521ab1'},doctree,0,0,0
0719032,{'file_name': '0719032'},doctree,0,0,0
aca3921,{'file_name': 'aca3921'},doctree,0,0,0
3845ac6,{'file_name': '3845ac6'},doctree,0,0,0
35e5834,{'file_name': '35e5834'},doctree,0,0,0
b878eca,{'file_name': 'b878eca'},doctree,0,0,0
9a94e57,{'file_name': '9a94e57'},doctree,0,0,0
212038e,{'file_name': '212038e'},doctree,0,0,0
5cd0d1a,{'file_name': '5cd0d1a'},doctree,0,0,0
aef6281,{'file_name': 'aef6281'},doctree,0,0,0
3379b38,{'file_name': '3379b38'},doctree,0,0,0
e92bbc2,{'file_name': 'e92bbc2'},doctree,0,0,0
b40443b,{'file_name': 'b40443b'},doctree,0,0,0
c13b85d,{'file_name': 'c13b85d'},doctree,0,0,0
bdc14ce,{'file_name': 'bdc14ce'},doctree,0,0,0
9744b46,{'file_name': '9744b46'},doctree,0,0,0
913519a,{'file_name': '913519a'},doctree,0,0,0
51eb825,{'file_name': '51eb825'},doctree,0,0,0
63d5366,{'file_name': '63d5366'},doctree,0,0,0
4e5a588,{'file_name': '4e5a588'},doctree,0,0,0
390fd43,{'file_name': '390fd43'},doctree,0,0,0
64f66dd,{'file_name': '64f66dd'},doctree,0,0,0
74470fe,{'file_name': '74470fe'},doctree,0,0,0
aa0909a,{'file_name': 'aa0909a'},doctree,0,0,0
f976ab7,{'file_name': 'f976ab7'},doctree,0,0,0
f518d07,{'file_name': 'f518d07'},doctree,0,0,0
2ca9860,{'file_name': '2ca9860'},doctree,0,0,0
a41e01a,{'file_name': 'a41e01a'},doctree,0,0,0
1455eda,{'file_name': '1455eda'},doctree,0,0,0
f80d63b,{'file_name': 'f80d63b'},doctree,0,0,0
167c746,{'file_name': '167c746'},doctree,0,0,0
ee1af79,{'file_name': 'ee1af79'},doctree,0,0,0
4b21975,{'file_name': '4b21975'},doctree,0,0,0
6366291,{'file_name': '6366291'},doctree,0,0,0
0b25843,{'file_name': '0b25843'},doctree,0,0,0
f3d5eb2,{'file_name': 'f3d5eb2'},doctree,0,0,0
3cc9f3c,{'file_name': '3cc9f3c'},doctree,0,0,0
50f9d91,{'file_name': '50f9d91'},doctree,0,0,0
b89338e,{'file_name': 'b89338e'},doctree,0,0,0
be1873b,{'file_name': 'be1873b'},doctree,0,0,0
e5a3bec,{'file_name': 'e5a3bec'},doctree,0,0,0
7b68c22,{'file_name': '7b68c22'},doctree,0,0,0
7f3fced,{'file_name': '7f3fced'},doctree,0,0,0
77264bb,{'file_name': '77264bb'},doctree,0,0,0
2a42669,{'file_name': '2a42669'},doctree,0,0,0
da9e130,{'file_name': 'da9e130'},doctree,0,0,0
46ef1fa,{'file_name': '46ef1fa'},doctree,0,0,0
86e2806,{'file_name': '86e2806'},doctree,0,0,0
36f7644,{'file_name': '36f7644'},doctree,0,0,0
962ba59,{'file_name': '962ba59'},doctree,0,0,0
7716456,{'file_name': '7716456'},doctree,0,0,0
6c9577d,{'file_name': '6c9577d'},doctree,0,0,0
718b344,{'file_name': '718b344'},doctree,0,0,0
64cd94b,{'file_name': '64cd94b'},doctree,0,0,0
bc8aa3b,{'file_name': 'bc8aa3b'},txt,0,43,43
7a8c07b,{'file_name': '7a8c07b'},txt,0,13,13
cec1f38,{'file_name': 'cec1f38'},txt,0,152,152
f450459,{'file_name': 'f450459'},txt,0,204,204
b3858a9,{'file_name': 'b3858a9'},txt,0,104,104
89a1418,{'file_name': '89a1418'},txt,0,76,76
1a05ba6,{'file_name': '1a05ba6'},txt,0,5,5
0f67fbe,{'file_name': '0f67fbe'},txt,0,46,46
a98ea8c,{'file_name': 'a98ea8c'},txt,0,22,22
fe55f4f,{'file_name': 'fe55f4f'},txt,0,14,14
4e3cdf9,{'file_name': '4e3cdf9'},txt,0,12,12
bd5c31d,{'file_name': 'bd5c31d'},txt,0,51,51
8add6a0,{'file_name': '8add6a0'},txt,0,74,74
3463e06,{'file_name': '3463e06'},txt,0,14,14
638a017,{'file_name': '638a017'},txt,0,45,45
7608d3f,{'file_name': '7608d3f'},txt,0,97,97
9cadf40,{'file_name': '9cadf40'},txt,0,38,38
3579e8a,{'file_name': '3579e8a'},txt,0,22,22
06941bf,{'file_name': '06941bf'},txt,0,30,30
73bed5a,{'file_name': '73bed5a'},txt,0,41,41
e753029,{'file_name': 'e753029'},txt,0,16,16
5b3eb40,{'file_name': '5b3eb40'},txt,0,4,4
fbe4cfa,{'file_name': 'fbe4cfa'},txt,0,91,91
49a0b51,{'file_name': '49a0b51'},txt,0,24,24
974fc3c,{'file_name': '974fc3c'},txt,0,27,27
7bf0719,{'file_name': '7bf0719'},txt,0,35,35
b45bba8,{'file_name': 'b45bba8'},txt,0,33,33
e5b7c98,{'file_name': 'e5b7c98'},txt,0,56,56
fefc54b,{'file_name': 'fefc54b'},txt,0,78,78
5cc796e,{'file_name': '5cc796e'},txt,0,8,8
2524740,{'file_name': '2524740'},txt,0,33,33
8a60294,{'file_name': '8a60294'},txt,0,29,29
f698feb,{'file_name': 'f698feb'},txt,0,54,54
49141e6,{'file_name': '49141e6'},txt,0,182,182
0c0a876,{'file_name': '0c0a876'},txt,0,10,10
9bf8b3a,{'file_name': '9bf8b3a'},txt,0,10,10
a3a09ff,{'file_name': 'a3a09ff'},txt,0,10,10
d648331,{'file_name': 'd648331'},txt,0,10,10
4a90acb,{'file_name': '4a90acb'},txt,0,10,10
2f741f5,{'file_name': '2f741f5'},txt,0,70,70
1093792,{'file_name': '1093792'},txt,0,10,10
aa607e2,{'file_name': 'aa607e2'},txt,0,57,57
e5474fa,{'file_name': 'e5474fa'},txt,0,10,10
5b1eec6,{'file_name': '5b1eec6'},txt,0,49,49
90396c4,{'file_name': '90396c4'},txt,0,10,10
438062a,{'file_name': '438062a'},txt,0,10,10
01746aa,{'file_name': '01746aa'},txt,0,10,10
0a9385c,{'file_name': '0a9385c'},txt,0,23,23
5a17ab5,{'file_name': '5a17ab5'},txt,0,10,10
d97ece6,{'file_name': 'd97ece6'},txt,0,10,10
8b0600e,{'file_name': '8b0600e'},txt,0,80,80
e0d955a,{'file_name': 'e0d955a'},txt,0,77,77
1e130f5,{'file_name': '1e130f5'},txt,0,5,5
27665fc,{'file_name': '27665fc'},txt,0,10,10
1637416,{'file_name': '1637416'},txt,0,10,10
57e3f0d,{'file_name': '57e3f0d'},txt,0,10,10
15d8b68,{'file_name': '15d8b68'},txt,0,10,10
eb81c9f,{'file_name': 'eb81c9f'},txt,0,10,10
c963b07,{'file_name': 'c963b07'},txt,0,10,10
aefba33,{'file_name': 'aefba33'},txt,0,47,47
aa9df31,{'file_name': 'aa9df31'},css,0,904,904
e380325,{'file_name': 'e380325'},css,0,1,1
6cb6000,{'file_name': '6cb6000'},woff,0,0,0
7059e23,{'file_name': '7059e23'},woff2,0,0,0
f815f63,{'file_name': 'f815f63'},woff,0,0,0
f2c76e5,{'file_name': 'f2c76e5'},woff2,0,0,0
e9f60ca,{'file_name': 'e9f60ca'},eot,0,0,0
855c845,{'file_name': '855c845'},svg,0,2671,2671
35acda2,{'file_name': '35acda2'},ttf,0,0,0
400014a,{'file_name': '400014a'},woff,0,0,0
4d13fc6,{'file_name': '4d13fc6'},woff2,0,0,0
88ad05b,{'file_name': '88ad05b'},woff,0,0,0
c4e3d80,{'file_name': 'c4e3d80'},woff2,0,0,0
c6dff51,{'file_name': 'c6dff51'},woff,0,0,0
bb19504,{'file_name': 'bb19504'},woff2,0,0,0
76114bc,{'file_name': '76114bc'},woff,0,0,0
3404f37,{'file_name': '3404f37'},woff2,0,0,0
ae1307f,{'file_name': 'ae1307f'},woff,0,0,0
3bf9843,{'file_name': '3bf9843'},woff2,0,0,0
8cd4f10,{'file_name': '8cd4f10'},css,0,4,4
61ac9d2,{'file_name': '61ac9d2'},js,0,321,321
2fa8c97,{'file_name': '2fa8c97'},js,0,12,12
a858a41,{'file_name': 'a858a41'},png,0,0,0
809c1f5,{'file_name': '809c1f5'},ttf,0,0,0
fc981ce,{'file_name': 'fc981ce'},ttf,0,0,0
4b8a36d,{'file_name': '4b8a36d'},ttf,0,0,0
1d23c70,{'file_name': '1d23c70'},ttf,0,0,0
0f3d0f8,{'file_name': '0f3d0f8'},ttf,0,0,0
3361183,{'file_name': '3361183'},eot,0,0,0
29f691d,{'file_name': '29f691d'},ttf,0,0,0
c6dff51,{'file_name': 'c6dff51'},woff,0,0,0
bb19504,{'file_name': 'bb19504'},woff2,0,0,0
3d41549,{'file_name': '3d41549'},eot,0,0,0
f402040,{'file_name': 'f402040'},ttf,0,0,0
88ad05b,{'file_name': '88ad05b'},woff,0,0,0
c4e3d80,{'file_name': 'c4e3d80'},woff2,0,0,0
3f82642,{'file_name': '3f82642'},eot,0,0,0
b4bfc9b,{'file_name': 'b4bfc9b'},ttf,0,0,0
76114bc,{'file_name': '76114bc'},woff,0,0,0
3404f37,{'file_name': '3404f37'},woff2,0,0,0
11e3f2a,{'file_name': '11e3f2a'},eot,0,0,0
74decd9,{'file_name': '74decd9'},ttf,0,0,0
ae1307f,{'file_name': 'ae1307f'},woff,0,0,0
3bf9843,{'file_name': '3bf9843'},woff2,0,0,0
df5d1df,{'file_name': 'df5d1df'},ttf,0,0,0
eb52a79,{'file_name': 'eb52a79'},ttf,0,0,0
79dc8ef,{'file_name': '79dc8ef'},eot,0,0,0
df5d1df,{'file_name': 'df5d1df'},ttf,0,0,0
6cb6000,{'file_name': '6cb6000'},woff,0,0,0
7059e23,{'file_name': '7059e23'},woff2,0,0,0
2f7ca78,{'file_name': '2f7ca78'},eot,0,0,0
eb52a79,{'file_name': 'eb52a79'},ttf,0,0,0
f815f63,{'file_name': 'f815f63'},woff,0,0,0
f2c76e5,{'file_name': 'f2c76e5'},woff2,0,0,0
e9f60ca,{'file_name': 'e9f60ca'},eot,0,0,0
855c845,{'file_name': '855c845'},svg,0,2671,2671
35acda2,{'file_name': '35acda2'},ttf,0,0,0
400014a,{'file_name': '400014a'},woff,0,0,0
4d13fc6,{'file_name': '4d13fc6'},woff2,0,0,0
5093733,{'file_name': '5093733'},js,0,10872,10872
b061403,{'file_name': 'b061403'},js,0,2,2
526d723,{'file_name': '526d723'},js,0,1,1
2b43bd0,{'file_name': '2b43bd0'},js,0,4,4
cd1c674,{'file_name': 'cd1c674'},js,0,4,4
f65d479,{'file_name': 'f65d479'},js,0,4,4
839d07e,{'file_name': '839d07e'},js,0,1,1
863704b,{'file_name': '863704b'},js,0,297,297
d96755f,{'file_name': 'd96755f'},png,0,0,0
7107cec,{'file_name': '7107cec'},png,0,0,0
582d5c3,{'file_name': '582d5c3'},css,0,74,74
e09f926,{'file_name': 'e09f926'},js,0,522,522
ffd77af,{'file_name': 'ffd77af'},js,0,2042,2042
cf177d4,{'file_name': 'cf177d4'},js,0,6,6
cc7ab8b,{'file_name': 'cc7ab8b'},html,0,222,222
1b86573,{'file_name': '1b86573'},html,0,269,269
e4a592c,{'file_name': 'e4a592c'},inv,0,0,0
c195829,{'file_name': 'c195829'},html,0,240,240
381a9f3,{'file_name': '381a9f3'},html,0,362,362
286ff27,{'file_name': '286ff27'},html,0,439,439
6ecc125,{'file_name': '6ecc125'},html,0,336,336
d36f128,{'file_name': 'd36f128'},html,0,350,350
9d6dc5d,{'file_name': '9d6dc5d'},html,0,235,235
88a9e7c,{'file_name': '88a9e7c'},html,0,272,272
c54cd47,{'file_name': 'c54cd47'},html,0,256,256
445f750,{'file_name': '445f750'},html,0,242,242
1c2a093,{'file_name': '1c2a093'},html,0,244,244
ecbd243,{'file_name': 'ecbd243'},html,0,295,295
e081124,{'file_name': 'e081124'},html,0,327,327
a7a46a5,{'file_name': 'a7a46a5'},html,0,243,243
b5e4c7f,{'file_name': 'b5e4c7f'},html,0,271,271
525d755,{'file_name': '525d755'},html,0,333,333
e7172b6,{'file_name': 'e7172b6'},html,0,245,245
8efd4e3,{'file_name': '8efd4e3'},html,0,234,234
fa9d04f,{'file_name': 'fa9d04f'},html,0,249,249
e76cde4,{'file_name': 'e76cde4'},html,0,248,248
3b2ff72,{'file_name': '3b2ff72'},html,0,233,233
8a7cde0,{'file_name': '8a7cde0'},html,0,221,221
ff4d10d,{'file_name': 'ff4d10d'},html,0,346,346
5e0e7c3,{'file_name': '5e0e7c3'},html,0,255,255
717022f,{'file_name': '717022f'},html,0,258,258
9e32e96,{'file_name': '9e32e96'},html,0,265,265
7c7a231,{'file_name': '7c7a231'},html,0,268,268
a61a3db,{'file_name': 'a61a3db'},html,0,284,284
ed276ee,{'file_name': 'ed276ee'},html,0,308,308
937d0a9,{'file_name': '937d0a9'},html,0,238,238
db1e722,{'file_name': 'db1e722'},html,0,271,271
6881698,{'file_name': '6881698'},html,0,258,258
f565225,{'file_name': 'f565225'},html,0,278,278
00ba74d,{'file_name': '00ba74d'},html,0,428,428
c25606f,{'file_name': 'c25606f'},html,0,239,239
fd0649d,{'file_name': 'fd0649d'},html,0,259,259
de0ed58,{'file_name': 'de0ed58'},html,0,259,259
7c68f86,{'file_name': '7c68f86'},html,0,259,259
b311239,{'file_name': 'b311239'},html,0,259,259
908bb3a,{'file_name': '908bb3a'},html,0,364,364
f707086,{'file_name': 'f707086'},html,0,259,259
345b132,{'file_name': '345b132'},html,0,316,316
f64ca57,{'file_name': 'f64ca57'},html,0,259,259
cde653c,{'file_name': 'cde653c'},html,0,326,326
bd53355,{'file_name': 'bd53355'},html,0,259,259
307b3a5,{'file_name': '307b3a5'},html,0,259,259
447506a,{'file_name': '447506a'},html,0,0,0
4f965f6,{'file_name': '4f965f6'},html,0,272,272
47aeb19,{'file_name': '47aeb19'},html,0,259,259
4ae28fe,{'file_name': '4ae28fe'},html,0,259,259
cde0302,{'file_name': 'cde0302'},html,0,375,375
2e4b3c8,{'file_name': '2e4b3c8'},html,0,379,379
43c8c06,{'file_name': '43c8c06'},html,0,252,252
c2858d4,{'file_name': 'c2858d4'},html,0,255,255
aca55ef,{'file_name': 'aca55ef'},html,0,259,259
26b5563,{'file_name': '26b5563'},html,0,259,259
41f1608,{'file_name': '41f1608'},html,0,241,241
767686c,{'file_name': '767686c'},html,0,241,241
70b3c19,{'file_name': '70b3c19'},html,0,241,241
70e092e,{'file_name': '70e092e'},html,0,299,299
4b391f5,{'file_name': '4b391f5'},html,0,235,235
b33f66d,{'file_name': 'b33f66d'},js,0,1,1
46d5905,{'file_name': '46d5905'},pickle,0,0,0
64cd94b,{'file_name': '64cd94b'},doctree,0,0,0
aefba33,{'file_name': 'aefba33'},txt,0,1,1
e4a592c,{'file_name': 'e4a592c'},inv,0,0,0
70e092e,{'file_name': '70e092e'},html,0,2,2
b33f66d,{'file_name': 'b33f66d'},js,1,1,2
245ae99,{'file_name': '245ae99'},gitignore,1,0,1
aefba33,{'file_name': 'aefba33'},rst,0,1,1
d97ece6,{'file_name': 'd97ece6'},rst,0,10,10
c2ce97e,{'file_name': 'c2ce97e'},gitignore,3,0,3
534cd8c,{'file_name': '534cd8c'},pickle,0,0,0
6366291,{'file_name': '6366291'},doctree,0,0,0
2a42669,{'file_name': '2a42669'},doctree,0,0,0
2f741f5,{'file_name': '2f741f5'},txt,62,2,64
8b0600e,{'file_name': '8b0600e'},txt,73,3,76
f7ff467,{'file_name': 'f7ff467'},inv,0,0,0
908bb3a,{'file_name': '908bb3a'},html,109,4,113
cde0302,{'file_name': 'cde0302'},html,120,4,124
d9885a9,{'file_name': 'd9885a9'},js,1,1,2
1f2a1f3,{'file_name': '1f2a1f3'},pickle,0,0,0
bb26b88,{'file_name': 'bb26b88'},doctree,0,0,0
57309b0,{'file_name': '57309b0'},doctree,0,0,0
951ab43,{'file_name': '951ab43'},doctree,0,0,0
e70c5c1,{'file_name': 'e70c5c1'},doctree,0,0,0
2f741f5,{'file_name': '2f741f5'},txt,62,2,64
5b1eec6,{'file_name': '5b1eec6'},txt,42,3,45
8b0600e,{'file_name': '8b0600e'},txt,73,3,76
e0d955a,{'file_name': 'e0d955a'},txt,4,4,8
908bb3a,{'file_name': '908bb3a'},html,109,4,113
cde653c,{'file_name': 'cde653c'},html,71,4,75
cde0302,{'file_name': 'cde0302'},html,120,4,124
2e4b3c8,{'file_name': '2e4b3c8'},html,8,8,16
d9885a9,{'file_name': 'd9885a9'},js,1,1,2
8b0600e,{'file_name': '8b0600e'},rst,73,3,76
2f741f5,{'file_name': '2f741f5'},rst,62,2,64
0bbf11c,{'file_name': '0bbf11c'},buildinfo,4,0,4
03ab110,{'file_name': '03ab110'},pickle,0,0,0
dfd39c4,{'file_name': 'dfd39c4'},doctree,0,0,0
eb71731,{'file_name': 'eb71731'},doctree,0,0,0
3698e9f,{'file_name': '3698e9f'},doctree,0,0,0
0d64f6a,{'file_name': '0d64f6a'},doctree,0,0,0
6a4e924,{'file_name': '6a4e924'},doctree,0,0,0
0413361,{'file_name': '0413361'},doctree,0,0,0
c521ab1,{'file_name': 'c521ab1'},doctree,0,0,0
0719032,{'file_name': '0719032'},doctree,0,0,0
aca3921,{'file_name': 'aca3921'},doctree,0,0,0
3845ac6,{'file_name': '3845ac6'},doctree,0,0,0
35e5834,{'file_name': '35e5834'},doctree,0,0,0
b878eca,{'file_name': 'b878eca'},doctree,0,0,0
9a94e57,{'file_name': '9a94e57'},doctree,0,0,0
212038e,{'file_name': '212038e'},doctree,0,0,0
5cd0d1a,{'file_name': '5cd0d1a'},doctree,0,0,0
aef6281,{'file_name': 'aef6281'},doctree,0,0,0
3379b38,{'file_name': '3379b38'},doctree,0,0,0
e92bbc2,{'file_name': 'e92bbc2'},doctree,0,0,0
b40443b,{'file_name': 'b40443b'},doctree,0,0,0
c13b85d,{'file_name': 'c13b85d'},doctree,0,0,0
bdc14ce,{'file_name': 'bdc14ce'},doctree,0,0,0
9744b46,{'file_name': '9744b46'},doctree,0,0,0
913519a,{'file_name': '913519a'},doctree,0,0,0
51eb825,{'file_name': '51eb825'},doctree,0,0,0
63d5366,{'file_name': '63d5366'},doctree,0,0,0
4e5a588,{'file_name': '4e5a588'},doctree,0,0,0
390fd43,{'file_name': '390fd43'},doctree,0,0,0
64f66dd,{'file_name': '64f66dd'},doctree,0,0,0
74470fe,{'file_name': '74470fe'},doctree,0,0,0
aa0909a,{'file_name': 'aa0909a'},doctree,0,0,0
f976ab7,{'file_name': 'f976ab7'},doctree,0,0,0
f518d07,{'file_name': 'f518d07'},doctree,0,0,0
2ca9860,{'file_name': '2ca9860'},doctree,0,0,0
a41e01a,{'file_name': 'a41e01a'},doctree,0,0,0
1455eda,{'file_name': '1455eda'},doctree,0,0,0
f80d63b,{'file_name': 'f80d63b'},doctree,0,0,0
167c746,{'file_name': '167c746'},doctree,0,0,0
ee1af79,{'file_name': 'ee1af79'},doctree,0,0,0
4b21975,{'file_name': '4b21975'},doctree,0,0,0
aa04b6d,{'file_name': 'aa04b6d'},doctree,0,0,0
0b25843,{'file_name': '0b25843'},doctree,0,0,0
f3d5eb2,{'file_name': 'f3d5eb2'},doctree,0,0,0
3cc9f3c,{'file_name': '3cc9f3c'},doctree,0,0,0
50f9d91,{'file_name': '50f9d91'},doctree,0,0,0
b89338e,{'file_name': 'b89338e'},doctree,0,0,0
be1873b,{'file_name': 'be1873b'},doctree,0,0,0
e5a3bec,{'file_name': 'e5a3bec'},doctree,0,0,0
7b68c22,{'file_name': '7b68c22'},doctree,0,0,0
7f3fced,{'file_name': '7f3fced'},doctree,0,0,0
77264bb,{'file_name': '77264bb'},doctree,0,0,0
94c0158,{'file_name': '94c0158'},doctree,0,0,0
da9e130,{'file_name': 'da9e130'},doctree,0,0,0
46ef1fa,{'file_name': '46ef1fa'},doctree,0,0,0
86e2806,{'file_name': '86e2806'},doctree,0,0,0
36f7644,{'file_name': '36f7644'},doctree,0,0,0
962ba59,{'file_name': '962ba59'},doctree,0,0,0
7716456,{'file_name': '7716456'},doctree,0,0,0
6c9577d,{'file_name': '6c9577d'},doctree,0,0,0
718b344,{'file_name': '718b344'},doctree,0,0,0
2e53210,{'file_name': '2e53210'},doctree,0,0,0
bc8aa3b,{'file_name': 'bc8aa3b'},txt,43,0,43
7a8c07b,{'file_name': '7a8c07b'},txt,13,0,13
cec1f38,{'file_name': 'cec1f38'},txt,152,0,152
f450459,{'file_name': 'f450459'},txt,204,0,204
b3858a9,{'file_name': 'b3858a9'},txt,104,0,104
89a1418,{'file_name': '89a1418'},txt,76,0,76
1a05ba6,{'file_name': '1a05ba6'},txt,5,0,5
0f67fbe,{'file_name': '0f67fbe'},txt,46,0,46
a98ea8c,{'file_name': 'a98ea8c'},txt,22,0,22
fe55f4f,{'file_name': 'fe55f4f'},txt,14,0,14
4e3cdf9,{'file_name': '4e3cdf9'},txt,12,0,12
bd5c31d,{'file_name': 'bd5c31d'},txt,51,0,51
8add6a0,{'file_name': '8add6a0'},txt,74,0,74
3463e06,{'file_name': '3463e06'},txt,14,0,14
638a017,{'file_name': '638a017'},txt,45,0,45
7608d3f,{'file_name': '7608d3f'},txt,97,0,97
9cadf40,{'file_name': '9cadf40'},txt,38,0,38
3579e8a,{'file_name': '3579e8a'},txt,22,0,22
06941bf,{'file_name': '06941bf'},txt,30,0,30
73bed5a,{'file_name': '73bed5a'},txt,41,0,41
e753029,{'file_name': 'e753029'},txt,16,0,16
5b3eb40,{'file_name': '5b3eb40'},txt,4,0,4
fbe4cfa,{'file_name': 'fbe4cfa'},txt,91,0,91
49a0b51,{'file_name': '49a0b51'},txt,24,0,24
974fc3c,{'file_name': '974fc3c'},txt,27,0,27
7bf0719,{'file_name': '7bf0719'},txt,35,0,35
b45bba8,{'file_name': 'b45bba8'},txt,33,0,33
e5b7c98,{'file_name': 'e5b7c98'},txt,56,0,56
fefc54b,{'file_name': 'fefc54b'},txt,78,0,78
5cc796e,{'file_name': '5cc796e'},txt,8,0,8
2524740,{'file_name': '2524740'},txt,33,0,33
8a60294,{'file_name': '8a60294'},txt,29,0,29
f698feb,{'file_name': 'f698feb'},txt,54,0,54
49141e6,{'file_name': '49141e6'},txt,182,0,182
0c0a876,{'file_name': '0c0a876'},txt,10,0,10
9bf8b3a,{'file_name': '9bf8b3a'},txt,10,0,10
a3a09ff,{'file_name': 'a3a09ff'},txt,10,0,10
d648331,{'file_name': 'd648331'},txt,10,0,10
4a90acb,{'file_name': '4a90acb'},txt,10,0,10
c01f891,{'file_name': 'c01f891'},txt,10,0,10
1093792,{'file_name': '1093792'},txt,10,0,10
aa607e2,{'file_name': 'aa607e2'},txt,57,0,57
e5474fa,{'file_name': 'e5474fa'},txt,10,0,10
5b1eec6,{'file_name': '5b1eec6'},txt,49,0,49
90396c4,{'file_name': '90396c4'},txt,10,0,10
438062a,{'file_name': '438062a'},txt,10,0,10
01746aa,{'file_name': '01746aa'},txt,10,0,10
0a9385c,{'file_name': '0a9385c'},txt,23,0,23
5a17ab5,{'file_name': '5a17ab5'},txt,10,0,10
d97ece6,{'file_name': 'd97ece6'},txt,10,0,10
a8ca939,{'file_name': 'a8ca939'},txt,10,0,10
e0d955a,{'file_name': 'e0d955a'},txt,77,0,77
1e130f5,{'file_name': '1e130f5'},txt,5,0,5
27665fc,{'file_name': '27665fc'},txt,10,0,10
1637416,{'file_name': '1637416'},txt,10,0,10
57e3f0d,{'file_name': '57e3f0d'},txt,10,0,10
15d8b68,{'file_name': '15d8b68'},txt,10,0,10
eb81c9f,{'file_name': 'eb81c9f'},txt,10,0,10
c963b07,{'file_name': 'c963b07'},txt,10,0,10
87a5038,{'file_name': '87a5038'},txt,48,0,48
aa9df31,{'file_name': 'aa9df31'},css,904,0,904
e380325,{'file_name': 'e380325'},css,1,0,1
6cb6000,{'file_name': '6cb6000'},woff,0,0,0
7059e23,{'file_name': '7059e23'},woff2,0,0,0
f815f63,{'file_name': 'f815f63'},woff,0,0,0
f2c76e5,{'file_name': 'f2c76e5'},woff2,0,0,0
e9f60ca,{'file_name': 'e9f60ca'},eot,0,0,0
855c845,{'file_name': '855c845'},svg,2671,0,2671
35acda2,{'file_name': '35acda2'},ttf,0,0,0
400014a,{'file_name': '400014a'},woff,0,0,0
4d13fc6,{'file_name': '4d13fc6'},woff2,0,0,0
88ad05b,{'file_name': '88ad05b'},woff,0,0,0
c4e3d80,{'file_name': 'c4e3d80'},woff2,0,0,0
c6dff51,{'file_name': 'c6dff51'},woff,0,0,0
bb19504,{'file_name': 'bb19504'},woff2,0,0,0
76114bc,{'file_name': '76114bc'},woff,0,0,0
3404f37,{'file_name': '3404f37'},woff2,0,0,0
ae1307f,{'file_name': 'ae1307f'},woff,0,0,0
3bf9843,{'file_name': '3bf9843'},woff2,0,0,0
8cd4f10,{'file_name': '8cd4f10'},css,4,0,4
61ac9d2,{'file_name': '61ac9d2'},js,321,0,321
2fa8c97,{'file_name': '2fa8c97'},js,12,0,12
a858a41,{'file_name': 'a858a41'},png,0,0,0
809c1f5,{'file_name': '809c1f5'},ttf,0,0,0
fc981ce,{'file_name': 'fc981ce'},ttf,0,0,0
4b8a36d,{'file_name': '4b8a36d'},ttf,0,0,0
1d23c70,{'file_name': '1d23c70'},ttf,0,0,0
0f3d0f8,{'file_name': '0f3d0f8'},ttf,0,0,0
3361183,{'file_name': '3361183'},eot,0,0,0
29f691d,{'file_name': '29f691d'},ttf,0,0,0
c6dff51,{'file_name': 'c6dff51'},woff,0,0,0
bb19504,{'file_name': 'bb19504'},woff2,0,0,0
3d41549,{'file_name': '3d41549'},eot,0,0,0
f402040,{'file_name': 'f402040'},ttf,0,0,0
88ad05b,{'file_name': '88ad05b'},woff,0,0,0
c4e3d80,{'file_name': 'c4e3d80'},woff2,0,0,0
3f82642,{'file_name': '3f82642'},eot,0,0,0
b4bfc9b,{'file_name': 'b4bfc9b'},ttf,0,0,0
76114bc,{'file_name': '76114bc'},woff,0,0,0
3404f37,{'file_name': '3404f37'},woff2,0,0,0
11e3f2a,{'file_name': '11e3f2a'},eot,0,0,0
74decd9,{'file_name': '74decd9'},ttf,0,0,0
ae1307f,{'file_name': 'ae1307f'},woff,0,0,0
3bf9843,{'file_name': '3bf9843'},woff2,0,0,0
df5d1df,{'file_name': 'df5d1df'},ttf,0,0,0
eb52a79,{'file_name': 'eb52a79'},ttf,0,0,0
79dc8ef,{'file_name': '79dc8ef'},eot,0,0,0
df5d1df,{'file_name': 'df5d1df'},ttf,0,0,0
6cb6000,{'file_name': '6cb6000'},woff,0,0,0
7059e23,{'file_name': '7059e23'},woff2,0,0,0
2f7ca78,{'file_name': '2f7ca78'},eot,0,0,0
eb52a79,{'file_name': 'eb52a79'},ttf,0,0,0
f815f63,{'file_name': 'f815f63'},woff,0,0,0
f2c76e5,{'file_name': 'f2c76e5'},woff2,0,0,0
e9f60ca,{'file_name': 'e9f60ca'},eot,0,0,0
855c845,{'file_name': '855c845'},svg,2671,0,2671
35acda2,{'file_name': '35acda2'},ttf,0,0,0
400014a,{'file_name': '400014a'},woff,0,0,0
4d13fc6,{'file_name': '4d13fc6'},woff2,0,0,0
5093733,{'file_name': '5093733'},js,10872,0,10872
b061403,{'file_name': 'b061403'},js,2,0,2
526d723,{'file_name': '526d723'},js,1,0,1
2b43bd0,{'file_name': '2b43bd0'},js,4,0,4
cd1c674,{'file_name': 'cd1c674'},js,4,0,4
f65d479,{'file_name': 'f65d479'},js,4,0,4
839d07e,{'file_name': '839d07e'},js,1,0,1
863704b,{'file_name': '863704b'},js,297,0,297
d96755f,{'file_name': 'd96755f'},png,0,0,0
7107cec,{'file_name': '7107cec'},png,0,0,0
582d5c3,{'file_name': '582d5c3'},css,74,0,74
e09f926,{'file_name': 'e09f926'},js,522,0,522
ffd77af,{'file_name': 'ffd77af'},js,2042,0,2042
cf177d4,{'file_name': 'cf177d4'},js,6,0,6
cc7ab8b,{'file_name': 'cc7ab8b'},html,222,0,222
1b86573,{'file_name': '1b86573'},html,269,0,269
fe3845d,{'file_name': 'fe3845d'},inv,0,0,0
c195829,{'file_name': 'c195829'},html,240,0,240
381a9f3,{'file_name': '381a9f3'},html,362,0,362
286ff27,{'file_name': '286ff27'},html,439,0,439
6ecc125,{'file_name': '6ecc125'},html,336,0,336
d36f128,{'file_name': 'd36f128'},html,350,0,350
9d6dc5d,{'file_name': '9d6dc5d'},html,235,0,235
88a9e7c,{'file_name': '88a9e7c'},html,272,0,272
c54cd47,{'file_name': 'c54cd47'},html,256,0,256
445f750,{'file_name': '445f750'},html,242,0,242
1c2a093,{'file_name': '1c2a093'},html,244,0,244
ecbd243,{'file_name': 'ecbd243'},html,295,0,295
e081124,{'file_name': 'e081124'},html,327,0,327
a7a46a5,{'file_name': 'a7a46a5'},html,243,0,243
b5e4c7f,{'file_name': 'b5e4c7f'},html,271,0,271
525d755,{'file_name': '525d755'},html,333,0,333
e7172b6,{'file_name': 'e7172b6'},html,245,0,245
8efd4e3,{'file_name': '8efd4e3'},html,234,0,234
fa9d04f,{'file_name': 'fa9d04f'},html,249,0,249
e76cde4,{'file_name': 'e76cde4'},html,248,0,248
3b2ff72,{'file_name': '3b2ff72'},html,233,0,233
8a7cde0,{'file_name': '8a7cde0'},html,221,0,221
ff4d10d,{'file_name': 'ff4d10d'},html,346,0,346
5e0e7c3,{'file_name': '5e0e7c3'},html,255,0,255
717022f,{'file_name': '717022f'},html,258,0,258
9e32e96,{'file_name': '9e32e96'},html,265,0,265
7c7a231,{'file_name': '7c7a231'},html,268,0,268
a61a3db,{'file_name': 'a61a3db'},html,284,0,284
ed276ee,{'file_name': 'ed276ee'},html,308,0,308
937d0a9,{'file_name': '937d0a9'},html,238,0,238
db1e722,{'file_name': 'db1e722'},html,271,0,271
6881698,{'file_name': '6881698'},html,258,0,258
f565225,{'file_name': 'f565225'},html,278,0,278
00ba74d,{'file_name': '00ba74d'},html,428,0,428
c25606f,{'file_name': 'c25606f'},html,239,0,239
fd0649d,{'file_name': 'fd0649d'},html,259,0,259
de0ed58,{'file_name': 'de0ed58'},html,259,0,259
7c68f86,{'file_name': '7c68f86'},html,259,0,259
b311239,{'file_name': 'b311239'},html,259,0,259
be1f833,{'file_name': 'be1f833'},html,259,0,259
f707086,{'file_name': 'f707086'},html,259,0,259
345b132,{'file_name': '345b132'},html,316,0,316
f64ca57,{'file_name': 'f64ca57'},html,259,0,259
cde653c,{'file_name': 'cde653c'},html,326,0,326
bd53355,{'file_name': 'bd53355'},html,259,0,259
307b3a5,{'file_name': '307b3a5'},html,259,0,259
447506a,{'file_name': '447506a'},html,259,0,259
4f965f6,{'file_name': '4f965f6'},html,0,0,0
47aeb19,{'file_name': '47aeb19'},html,259,0,259
4ae28fe,{'file_name': '4ae28fe'},html,259,0,259
38d278e,{'file_name': '38d278e'},html,259,0,259
2e4b3c8,{'file_name': '2e4b3c8'},html,379,0,379
43c8c06,{'file_name': '43c8c06'},html,252,0,252
c2858d4,{'file_name': 'c2858d4'},html,255,0,255
aca55ef,{'file_name': 'aca55ef'},html,259,0,259
26b5563,{'file_name': '26b5563'},html,259,0,259
41f1608,{'file_name': '41f1608'},html,241,0,241
767686c,{'file_name': '767686c'},html,241,0,241
70b3c19,{'file_name': '70b3c19'},html,241,0,241
25ddeaf,{'file_name': '25ddeaf'},html,301,0,301
4b391f5,{'file_name': '4b391f5'},html,235,0,235
eb1f129,{'file_name': 'eb1f129'},js,1,0,1
e0d955a,{'file_name': 'e0d955a'},rst,4,4,8
5b1eec6,{'file_name': '5b1eec6'},rst,42,3,45
8b26b2f,{'file_name': '8b26b2f'},code-workspace,2,1,3
dcf9568,{'file_name': 'dcf9568'},json,2,2,4
aa33899,{'file_name': 'aa33899'},md,1,1,2
21190b5,{'file_name': '21190b5'},md,2,0,2
e2728ac,{'file_name': 'e2728ac'},code-workspace,5,1,6
26b6167,{'file_name': '26b6167'},pickle,0,0,0
2180815,{'file_name': '2180815'},doctree,0,0,0
25e5ec1,{'file_name': '25e5ec1'},doctree,0,0,0
7a594bc,{'file_name': '7a594bc'},doctree,0,0,0
b3998b6,{'file_name': 'b3998b6'},doctree,0,0,0
646fe42,{'file_name': '646fe42'},doctree,0,0,0
75457ab,{'file_name': '75457ab'},doctree,0,0,0
f1072fa,{'file_name': 'f1072fa'},doctree,0,0,0
037c5a0,{'file_name': '037c5a0'},doctree,0,0,0
70af38f,{'file_name': '70af38f'},doctree,0,0,0
3dee571,{'file_name': '3dee571'},doctree,0,0,0
681fa00,{'file_name': '681fa00'},doctree,0,0,0
82263d7,{'file_name': '82263d7'},doctree,0,0,0
84b3315,{'file_name': '84b3315'},doctree,0,0,0
35087c4,{'file_name': '35087c4'},doctree,0,0,0
26c5b2d,{'file_name': '26c5b2d'},doctree,0,0,0
0508aa1,{'file_name': '0508aa1'},doctree,0,0,0
6136941,{'file_name': '6136941'},doctree,0,0,0
ec2577c,{'file_name': 'ec2577c'},doctree,0,0,0
3fd8b29,{'file_name': '3fd8b29'},doctree,0,0,0
cfc4e14,{'file_name': 'cfc4e14'},doctree,0,0,0
795ca48,{'file_name': '795ca48'},doctree,0,0,0
b6882bc,{'file_name': 'b6882bc'},doctree,0,0,0
4291113,{'file_name': '4291113'},doctree,0,0,0
1470ece,{'file_name': '1470ece'},doctree,0,0,0
50e7956,{'file_name': '50e7956'},doctree,0,0,0
79b1377,{'file_name': '79b1377'},doctree,0,0,0
d58251b,{'file_name': 'd58251b'},doctree,0,0,0
14e8bad,{'file_name': '14e8bad'},doctree,0,0,0
aeb40ef,{'file_name': 'aeb40ef'},doctree,0,0,0
1549319,{'file_name': '1549319'},doctree,0,0,0
ff30939,{'file_name': 'ff30939'},doctree,0,0,0
d688685,{'file_name': 'd688685'},doctree,0,0,0
6733666,{'file_name': '6733666'},doctree,0,0,0
bd4fbaf,{'file_name': 'bd4fbaf'},doctree,0,0,0
fde4dd6,{'file_name': 'fde4dd6'},doctree,0,0,0
3ebc286,{'file_name': '3ebc286'},doctree,0,0,0
90f9a01,{'file_name': '90f9a01'},doctree,0,0,0
f9490b4,{'file_name': 'f9490b4'},doctree,0,0,0
4a333de,{'file_name': '4a333de'},doctree,0,0,0
49c9129,{'file_name': '49c9129'},doctree,0,0,0
860c842,{'file_name': '860c842'},doctree,0,0,0
9c40556,{'file_name': '9c40556'},doctree,0,0,0
91a26d4,{'file_name': '91a26d4'},doctree,0,0,0
0c2204a,{'file_name': '0c2204a'},doctree,0,0,0
33e756a,{'file_name': '33e756a'},doctree,0,0,0
5d01ca3,{'file_name': '5d01ca3'},doctree,0,0,0
b378168,{'file_name': 'b378168'},doctree,0,0,0
82039e9,{'file_name': '82039e9'},doctree,0,0,0
40eccc1,{'file_name': '40eccc1'},doctree,0,0,0
ee92d68,{'file_name': 'ee92d68'},doctree,0,0,0
fcb4e37,{'file_name': 'fcb4e37'},doctree,0,0,0
34fa18e,{'file_name': '34fa18e'},doctree,0,0,0
b701f99,{'file_name': 'b701f99'},doctree,0,0,0
4c4aaa6,{'file_name': '4c4aaa6'},doctree,0,0,0
b56484e,{'file_name': 'b56484e'},doctree,0,0,0
3c7460c,{'file_name': '3c7460c'},doctree,0,0,0
1e14848,{'file_name': '1e14848'},doctree,0,0,0
7064048,{'file_name': '7064048'},doctree,0,0,0
7469d45,{'file_name': '7469d45'},doctree,0,0,0
8567df2,{'file_name': '8567df2'},doctree,0,0,0
0bbf11c,{'file_name': '0bbf11c'},buildinfo,4,0,4
bc8aa3b,{'file_name': 'bc8aa3b'},txt,43,0,43
7a8c07b,{'file_name': '7a8c07b'},txt,13,0,13
cec1f38,{'file_name': 'cec1f38'},txt,152,0,152
f450459,{'file_name': 'f450459'},txt,204,0,204
b3858a9,{'file_name': 'b3858a9'},txt,104,0,104
89a1418,{'file_name': '89a1418'},txt,76,0,76
1a05ba6,{'file_name': '1a05ba6'},txt,5,0,5
0f67fbe,{'file_name': '0f67fbe'},txt,46,0,46
a98ea8c,{'file_name': 'a98ea8c'},txt,22,0,22
fe55f4f,{'file_name': 'fe55f4f'},txt,14,0,14
4e3cdf9,{'file_name': '4e3cdf9'},txt,12,0,12
bd5c31d,{'file_name': 'bd5c31d'},txt,51,0,51
8add6a0,{'file_name': '8add6a0'},txt,74,0,74
3463e06,{'file_name': '3463e06'},txt,14,0,14
638a017,{'file_name': '638a017'},txt,45,0,45
7608d3f,{'file_name': '7608d3f'},txt,97,0,97
9cadf40,{'file_name': '9cadf40'},txt,38,0,38
3579e8a,{'file_name': '3579e8a'},txt,22,0,22
06941bf,{'file_name': '06941bf'},txt,30,0,30
73bed5a,{'file_name': '73bed5a'},txt,41,0,41
e753029,{'file_name': 'e753029'},txt,16,0,16
5b3eb40,{'file_name': '5b3eb40'},txt,4,0,4
fbe4cfa,{'file_name': 'fbe4cfa'},txt,91,0,91
49a0b51,{'file_name': '49a0b51'},txt,24,0,24
974fc3c,{'file_name': '974fc3c'},txt,27,0,27
7bf0719,{'file_name': '7bf0719'},txt,35,0,35
b45bba8,{'file_name': 'b45bba8'},txt,33,0,33
e5b7c98,{'file_name': 'e5b7c98'},txt,56,0,56
fefc54b,{'file_name': 'fefc54b'},txt,78,0,78
5cc796e,{'file_name': '5cc796e'},txt,8,0,8
2524740,{'file_name': '2524740'},txt,33,0,33
8a60294,{'file_name': '8a60294'},txt,29,0,29
f698feb,{'file_name': 'f698feb'},txt,54,0,54
49141e6,{'file_name': '49141e6'},txt,182,0,182
0c0a876,{'file_name': '0c0a876'},txt,10,0,10
9bf8b3a,{'file_name': '9bf8b3a'},txt,10,0,10
a3a09ff,{'file_name': 'a3a09ff'},txt,10,0,10
d648331,{'file_name': 'd648331'},txt,10,0,10
4a90acb,{'file_name': '4a90acb'},txt,10,0,10
c01f891,{'file_name': 'c01f891'},txt,10,0,10
1093792,{'file_name': '1093792'},txt,10,0,10
aa607e2,{'file_name': 'aa607e2'},txt,57,0,57
e5474fa,{'file_name': 'e5474fa'},txt,10,0,10
49ffcc7,{'file_name': '49ffcc7'},txt,10,0,10
90396c4,{'file_name': '90396c4'},txt,10,0,10
438062a,{'file_name': '438062a'},txt,10,0,10
01746aa,{'file_name': '01746aa'},txt,10,0,10
0a9385c,{'file_name': '0a9385c'},txt,23,0,23
5a17ab5,{'file_name': '5a17ab5'},txt,10,0,10
d97ece6,{'file_name': 'd97ece6'},txt,10,0,10
a8ca939,{'file_name': 'a8ca939'},txt,10,0,10
5b60094,{'file_name': '5b60094'},txt,77,0,77
1e130f5,{'file_name': '1e130f5'},txt,5,0,5
27665fc,{'file_name': '27665fc'},txt,10,0,10
1637416,{'file_name': '1637416'},txt,10,0,10
57e3f0d,{'file_name': '57e3f0d'},txt,10,0,10
15d8b68,{'file_name': '15d8b68'},txt,10,0,10
eb81c9f,{'file_name': 'eb81c9f'},txt,10,0,10
c963b07,{'file_name': 'c963b07'},txt,10,0,10
87a5038,{'file_name': '87a5038'},txt,48,0,48
aa9df31,{'file_name': 'aa9df31'},css,904,0,904
e380325,{'file_name': 'e380325'},css,1,0,1
6cb6000,{'file_name': '6cb6000'},woff,0,0,0
7059e23,{'file_name': '7059e23'},woff2,0,0,0
f815f63,{'file_name': 'f815f63'},woff,0,0,0
f2c76e5,{'file_name': 'f2c76e5'},woff2,0,0,0
e9f60ca,{'file_name': 'e9f60ca'},eot,0,0,0
855c845,{'file_name': '855c845'},svg,2671,0,2671
35acda2,{'file_name': '35acda2'},ttf,0,0,0
400014a,{'file_name': '400014a'},woff,0,0,0
4d13fc6,{'file_name': '4d13fc6'},woff2,0,0,0
88ad05b,{'file_name': '88ad05b'},woff,0,0,0
c4e3d80,{'file_name': 'c4e3d80'},woff2,0,0,0
c6dff51,{'file_name': 'c6dff51'},woff,0,0,0
bb19504,{'file_name': 'bb19504'},woff2,0,0,0
76114bc,{'file_name': '76114bc'},woff,0,0,0
3404f37,{'file_name': '3404f37'},woff2,0,0,0
ae1307f,{'file_name': 'ae1307f'},woff,0,0,0
3bf9843,{'file_name': '3bf9843'},woff2,0,0,0
8cd4f10,{'file_name': '8cd4f10'},css,4,0,4
61ac9d2,{'file_name': '61ac9d2'},js,321,0,321
2fa8c97,{'file_name': '2fa8c97'},js,12,0,12
a858a41,{'file_name': 'a858a41'},png,0,0,0
809c1f5,{'file_name': '809c1f5'},ttf,0,0,0
fc981ce,{'file_name': 'fc981ce'},ttf,0,0,0
4b8a36d,{'file_name': '4b8a36d'},ttf,0,0,0
1d23c70,{'file_name': '1d23c70'},ttf,0,0,0
0f3d0f8,{'file_name': '0f3d0f8'},ttf,0,0,0
3361183,{'file_name': '3361183'},eot,0,0,0
29f691d,{'file_name': '29f691d'},ttf,0,0,0
c6dff51,{'file_name': 'c6dff51'},woff,0,0,0
bb19504,{'file_name': 'bb19504'},woff2,0,0,0
3d41549,{'file_name': '3d41549'},eot,0,0,0
f402040,{'file_name': 'f402040'},ttf,0,0,0
88ad05b,{'file_name': '88ad05b'},woff,0,0,0
c4e3d80,{'file_name': 'c4e3d80'},woff2,0,0,0
3f82642,{'file_name': '3f82642'},eot,0,0,0
b4bfc9b,{'file_name': 'b4bfc9b'},ttf,0,0,0
76114bc,{'file_name': '76114bc'},woff,0,0,0
3404f37,{'file_name': '3404f37'},woff2,0,0,0
11e3f2a,{'file_name': '11e3f2a'},eot,0,0,0
74decd9,{'file_name': '74decd9'},ttf,0,0,0
ae1307f,{'file_name': 'ae1307f'},woff,0,0,0
3bf9843,{'file_name': '3bf9843'},woff2,0,0,0
df5d1df,{'file_name': 'df5d1df'},ttf,0,0,0
eb52a79,{'file_name': 'eb52a79'},ttf,0,0,0
79dc8ef,{'file_name': '79dc8ef'},eot,0,0,0
df5d1df,{'file_name': 'df5d1df'},ttf,0,0,0
6cb6000,{'file_name': '6cb6000'},woff,0,0,0
7059e23,{'file_name': '7059e23'},woff2,0,0,0
2f7ca78,{'file_name': '2f7ca78'},eot,0,0,0
eb52a79,{'file_name': 'eb52a79'},ttf,0,0,0
f815f63,{'file_name': 'f815f63'},woff,0,0,0
f2c76e5,{'file_name': 'f2c76e5'},woff2,0,0,0
e9f60ca,{'file_name': 'e9f60ca'},eot,0,0,0
855c845,{'file_name': '855c845'},svg,2671,0,2671
35acda2,{'file_name': '35acda2'},ttf,0,0,0
400014a,{'file_name': '400014a'},woff,0,0,0
4d13fc6,{'file_name': '4d13fc6'},woff2,0,0,0
5093733,{'file_name': '5093733'},js,10872,0,10872
b061403,{'file_name': 'b061403'},js,2,0,2
526d723,{'file_name': '526d723'},js,1,0,1
2b43bd0,{'file_name': '2b43bd0'},js,4,0,4
cd1c674,{'file_name': 'cd1c674'},js,4,0,4
f65d479,{'file_name': 'f65d479'},js,4,0,4
839d07e,{'file_name': '839d07e'},js,1,0,1
863704b,{'file_name': '863704b'},js,297,0,297
d96755f,{'file_name': 'd96755f'},png,0,0,0
7107cec,{'file_name': '7107cec'},png,0,0,0
582d5c3,{'file_name': '582d5c3'},css,74,0,74
e09f926,{'file_name': 'e09f926'},js,522,0,522
ffd77af,{'file_name': 'ffd77af'},js,2042,0,2042
cf177d4,{'file_name': 'cf177d4'},js,6,0,6
cc7ab8b,{'file_name': 'cc7ab8b'},html,222,0,222
1b86573,{'file_name': '1b86573'},html,269,0,269
fe3845d,{'file_name': 'fe3845d'},inv,0,0,0
c195829,{'file_name': 'c195829'},html,240,0,240
381a9f3,{'file_name': '381a9f3'},html,362,0,362
286ff27,{'file_name': '286ff27'},html,439,0,439
6ecc125,{'file_name': '6ecc125'},html,336,0,336
d36f128,{'file_name': 'd36f128'},html,350,0,350
9d6dc5d,{'file_name': '9d6dc5d'},html,235,0,235
88a9e7c,{'file_name': '88a9e7c'},html,272,0,272
c54cd47,{'file_name': 'c54cd47'},html,256,0,256
445f750,{'file_name': '445f750'},html,242,0,242
1c2a093,{'file_name': '1c2a093'},html,244,0,244
ecbd243,{'file_name': 'ecbd243'},html,295,0,295
e081124,{'file_name': 'e081124'},html,327,0,327
a7a46a5,{'file_name': 'a7a46a5'},html,243,0,243
b5e4c7f,{'file_name': 'b5e4c7f'},html,271,0,271
525d755,{'file_name': '525d755'},html,333,0,333
e7172b6,{'file_name': 'e7172b6'},html,245,0,245
8efd4e3,{'file_name': '8efd4e3'},html,234,0,234
fa9d04f,{'file_name': 'fa9d04f'},html,249,0,249
e76cde4,{'file_name': 'e76cde4'},html,248,0,248
3b2ff72,{'file_name': '3b2ff72'},html,233,0,233
8a7cde0,{'file_name': '8a7cde0'},html,221,0,221
ff4d10d,{'file_name': 'ff4d10d'},html,346,0,346
5e0e7c3,{'file_name': '5e0e7c3'},html,255,0,255
717022f,{'file_name': '717022f'},html,258,0,258
9e32e96,{'file_name': '9e32e96'},html,265,0,265
7c7a231,{'file_name': '7c7a231'},html,268,0,268
a61a3db,{'file_name': 'a61a3db'},html,284,0,284
ed276ee,{'file_name': 'ed276ee'},html,308,0,308
937d0a9,{'file_name': '937d0a9'},html,238,0,238
db1e722,{'file_name': 'db1e722'},html,271,0,271
6881698,{'file_name': '6881698'},html,258,0,258
f565225,{'file_name': 'f565225'},html,278,0,278
00ba74d,{'file_name': '00ba74d'},html,428,0,428
c25606f,{'file_name': 'c25606f'},html,239,0,239
fd0649d,{'file_name': 'fd0649d'},html,259,0,259
de0ed58,{'file_name': 'de0ed58'},html,259,0,259
7c68f86,{'file_name': '7c68f86'},html,259,0,259
b311239,{'file_name': 'b311239'},html,259,0,259
be1f833,{'file_name': 'be1f833'},html,259,0,259
f707086,{'file_name': 'f707086'},html,259,0,259
345b132,{'file_name': '345b132'},html,316,0,316
f64ca57,{'file_name': 'f64ca57'},html,259,0,259
e46826e,{'file_name': 'e46826e'},html,259,0,259
bd53355,{'file_name': 'bd53355'},html,259,0,259
307b3a5,{'file_name': '307b3a5'},html,259,0,259
447506a,{'file_name': '447506a'},html,259,0,259
4f965f6,{'file_name': '4f965f6'},html,0,0,0
47aeb19,{'file_name': '47aeb19'},html,259,0,259
4ae28fe,{'file_name': '4ae28fe'},html,259,0,259
38d278e,{'file_name': '38d278e'},html,259,0,259
654c924,{'file_name': '654c924'},html,379,0,379
43c8c06,{'file_name': '43c8c06'},html,252,0,252
c2858d4,{'file_name': 'c2858d4'},html,255,0,255
aca55ef,{'file_name': 'aca55ef'},html,259,0,259
26b5563,{'file_name': '26b5563'},html,259,0,259
41f1608,{'file_name': '41f1608'},html,241,0,241
767686c,{'file_name': '767686c'},html,241,0,241
70b3c19,{'file_name': '70b3c19'},html,241,0,241
25ddeaf,{'file_name': '25ddeaf'},html,301,0,301
4b391f5,{'file_name': '4b391f5'},html,235,0,235
9fa8172,{'file_name': '9fa8172'},js,1,0,1
bc8aa3b,{'file_name': 'bc8aa3b'},rst,0,5,5
fa4c012,{'file_name': 'fa4c012'},pickle,0,0,0
42ff614,{'file_name': '42ff614'},doctree,0,0,0
25e5ec1,{'file_name': '25e5ec1'},doctree,0,0,0
7a594bc,{'file_name': '7a594bc'},doctree,0,0,0
b3998b6,{'file_name': 'b3998b6'},doctree,0,0,0
646fe42,{'file_name': '646fe42'},doctree,0,0,0
75457ab,{'file_name': '75457ab'},doctree,0,0,0
f1072fa,{'file_name': 'f1072fa'},doctree,0,0,0
037c5a0,{'file_name': '037c5a0'},doctree,0,0,0
70af38f,{'file_name': '70af38f'},doctree,0,0,0
3dee571,{'file_name': '3dee571'},doctree,0,0,0
681fa00,{'file_name': '681fa00'},doctree,0,0,0
82263d7,{'file_name': '82263d7'},doctree,0,0,0
84b3315,{'file_name': '84b3315'},doctree,0,0,0
35087c4,{'file_name': '35087c4'},doctree,0,0,0
26c5b2d,{'file_name': '26c5b2d'},doctree,0,0,0
0508aa1,{'file_name': '0508aa1'},doctree,0,0,0
6136941,{'file_name': '6136941'},doctree,0,0,0
ec2577c,{'file_name': 'ec2577c'},doctree,0,0,0
3fd8b29,{'file_name': '3fd8b29'},doctree,0,0,0
cfc4e14,{'file_name': 'cfc4e14'},doctree,0,0,0
795ca48,{'file_name': '795ca48'},doctree,0,0,0
b6882bc,{'file_name': 'b6882bc'},doctree,0,0,0
4291113,{'file_name': '4291113'},doctree,0,0,0
1470ece,{'file_name': '1470ece'},doctree,0,0,0
50e7956,{'file_name': '50e7956'},doctree,0,0,0
79b1377,{'file_name': '79b1377'},doctree,0,0,0
d58251b,{'file_name': 'd58251b'},doctree,0,0,0
14e8bad,{'file_name': '14e8bad'},doctree,0,0,0
aeb40ef,{'file_name': 'aeb40ef'},doctree,0,0,0
1549319,{'file_name': '1549319'},doctree,0,0,0
ff30939,{'file_name': 'ff30939'},doctree,0,0,0
d688685,{'file_name': 'd688685'},doctree,0,0,0
6733666,{'file_name': '6733666'},doctree,0,0,0
bd4fbaf,{'file_name': 'bd4fbaf'},doctree,0,0,0
fde4dd6,{'file_name': 'fde4dd6'},doctree,0,0,0
3ebc286,{'file_name': '3ebc286'},doctree,0,0,0
90f9a01,{'file_name': '90f9a01'},doctree,0,0,0
f9490b4,{'file_name': 'f9490b4'},doctree,0,0,0
4a333de,{'file_name': '4a333de'},doctree,0,0,0
49c9129,{'file_name': '49c9129'},doctree,0,0,0
860c842,{'file_name': '860c842'},doctree,0,0,0
9c40556,{'file_name': '9c40556'},doctree,0,0,0
91a26d4,{'file_name': '91a26d4'},doctree,0,0,0
0c2204a,{'file_name': '0c2204a'},doctree,0,0,0
33e756a,{'file_name': '33e756a'},doctree,0,0,0
5d01ca3,{'file_name': '5d01ca3'},doctree,0,0,0
b378168,{'file_name': 'b378168'},doctree,0,0,0
82039e9,{'file_name': '82039e9'},doctree,0,0,0
40eccc1,{'file_name': '40eccc1'},doctree,0,0,0
ee92d68,{'file_name': 'ee92d68'},doctree,0,0,0
fcb4e37,{'file_name': 'fcb4e37'},doctree,0,0,0
34fa18e,{'file_name': '34fa18e'},doctree,0,0,0
b701f99,{'file_name': 'b701f99'},doctree,0,0,0
4c4aaa6,{'file_name': '4c4aaa6'},doctree,0,0,0
b56484e,{'file_name': 'b56484e'},doctree,0,0,0
3c7460c,{'file_name': '3c7460c'},doctree,0,0,0
1e14848,{'file_name': '1e14848'},doctree,0,0,0
7064048,{'file_name': '7064048'},doctree,0,0,0
7469d45,{'file_name': '7469d45'},doctree,0,0,0
8567df2,{'file_name': '8567df2'},doctree,0,0,0
0bbf11c,{'file_name': '0bbf11c'},buildinfo,0,4,4
2f2551e,{'file_name': '2f2551e'},txt,0,20,20
7a8c07b,{'file_name': '7a8c07b'},txt,0,13,13
cec1f38,{'file_name': 'cec1f38'},txt,0,152,152
f450459,{'file_name': 'f450459'},txt,0,204,204
b3858a9,{'file_name': 'b3858a9'},txt,0,104,104
89a1418,{'file_name': '89a1418'},txt,0,76,76
1a05ba6,{'file_name': '1a05ba6'},txt,0,5,5
0f67fbe,{'file_name': '0f67fbe'},txt,0,46,46
a98ea8c,{'file_name': 'a98ea8c'},txt,0,22,22
fe55f4f,{'file_name': 'fe55f4f'},txt,0,14,14
4e3cdf9,{'file_name': '4e3cdf9'},txt,0,12,12
bd5c31d,{'file_name': 'bd5c31d'},txt,0,51,51
8add6a0,{'file_name': '8add6a0'},txt,0,74,74
3463e06,{'file_name': '3463e06'},txt,0,14,14
638a017,{'file_name': '638a017'},txt,0,45,45
7608d3f,{'file_name': '7608d3f'},txt,0,97,97
9cadf40,{'file_name': '9cadf40'},txt,0,38,38
3579e8a,{'file_name': '3579e8a'},txt,0,22,22
06941bf,{'file_name': '06941bf'},txt,0,30,30
73bed5a,{'file_name': '73bed5a'},txt,0,41,41
e753029,{'file_name': 'e753029'},txt,0,16,16
5b3eb40,{'file_name': '5b3eb40'},txt,0,4,4
fbe4cfa,{'file_name': 'fbe4cfa'},txt,0,91,91
49a0b51,{'file_name': '49a0b51'},txt,0,24,24
974fc3c,{'file_name': '974fc3c'},txt,0,27,27
7bf0719,{'file_name': '7bf0719'},txt,0,35,35
b45bba8,{'file_name': 'b45bba8'},txt,0,33,33
e5b7c98,{'file_name': 'e5b7c98'},txt,0,56,56
fefc54b,{'file_name': 'fefc54b'},txt,0,78,78
5cc796e,{'file_name': '5cc796e'},txt,0,8,8
2524740,{'file_name': '2524740'},txt,0,33,33
8a60294,{'file_name': '8a60294'},txt,0,29,29
f698feb,{'file_name': 'f698feb'},txt,0,54,54
49141e6,{'file_name': '49141e6'},txt,0,182,182
0c0a876,{'file_name': '0c0a876'},txt,0,10,10
9bf8b3a,{'file_name': '9bf8b3a'},txt,0,10,10
a3a09ff,{'file_name': 'a3a09ff'},txt,0,10,10
d648331,{'file_name': 'd648331'},txt,0,10,10
4a90acb,{'file_name': '4a90acb'},txt,0,10,10
c01f891,{'file_name': 'c01f891'},txt,0,10,10
1093792,{'file_name': '1093792'},txt,0,10,10
aa607e2,{'file_name': 'aa607e2'},txt,0,57,57
e5474fa,{'file_name': 'e5474fa'},txt,0,10,10
49ffcc7,{'file_name': '49ffcc7'},txt,0,10,10
90396c4,{'file_name': '90396c4'},txt,0,10,10
438062a,{'file_name': '438062a'},txt,0,10,10
01746aa,{'file_name': '01746aa'},txt,0,10,10
0a9385c,{'file_name': '0a9385c'},txt,0,23,23
5a17ab5,{'file_name': '5a17ab5'},txt,0,10,10
d97ece6,{'file_name': 'd97ece6'},txt,0,10,10
a8ca939,{'file_name': 'a8ca939'},txt,0,10,10
5b60094,{'file_name': '5b60094'},txt,0,77,77
1e130f5,{'file_name': '1e130f5'},txt,0,5,5
27665fc,{'file_name': '27665fc'},txt,0,10,10
1637416,{'file_name': '1637416'},txt,0,10,10
57e3f0d,{'file_name': '57e3f0d'},txt,0,10,10
15d8b68,{'file_name': '15d8b68'},txt,0,10,10
eb81c9f,{'file_name': 'eb81c9f'},txt,0,10,10
c963b07,{'file_name': 'c963b07'},txt,0,10,10
87a5038,{'file_name': '87a5038'},txt,0,48,48
0eddaeb,{'file_name': '0eddaeb'},css,0,701,701
aa9df31,{'file_name': 'aa9df31'},css,0,904,904
e380325,{'file_name': 'e380325'},css,0,1,1
6cb6000,{'file_name': '6cb6000'},woff,0,0,0
7059e23,{'file_name': '7059e23'},woff2,0,0,0
f815f63,{'file_name': 'f815f63'},woff,0,0,0
f2c76e5,{'file_name': 'f2c76e5'},woff2,0,0,0
e9f60ca,{'file_name': 'e9f60ca'},eot,0,0,0
855c845,{'file_name': '855c845'},svg,0,2671,2671
35acda2,{'file_name': '35acda2'},ttf,0,0,0
400014a,{'file_name': '400014a'},woff,0,0,0
4d13fc6,{'file_name': '4d13fc6'},woff2,0,0,0
88ad05b,{'file_name': '88ad05b'},woff,0,0,0
c4e3d80,{'file_name': 'c4e3d80'},woff2,0,0,0
c6dff51,{'file_name': 'c6dff51'},woff,0,0,0
bb19504,{'file_name': 'bb19504'},woff2,0,0,0
76114bc,{'file_name': '76114bc'},woff,0,0,0
3404f37,{'file_name': '3404f37'},woff2,0,0,0
ae1307f,{'file_name': 'ae1307f'},woff,0,0,0
3bf9843,{'file_name': '3bf9843'},woff2,0,0,0
8cd4f10,{'file_name': '8cd4f10'},css,0,4,4
2a924f1,{'file_name': '2a924f1'},css,0,1,1
61ac9d2,{'file_name': '61ac9d2'},js,0,321,321
2fa8c97,{'file_name': '2fa8c97'},js,0,12,12
a858a41,{'file_name': 'a858a41'},png,0,0,0
809c1f5,{'file_name': '809c1f5'},ttf,0,0,0
fc981ce,{'file_name': 'fc981ce'},ttf,0,0,0
4b8a36d,{'file_name': '4b8a36d'},ttf,0,0,0
1d23c70,{'file_name': '1d23c70'},ttf,0,0,0
0f3d0f8,{'file_name': '0f3d0f8'},ttf,0,0,0
3361183,{'file_name': '3361183'},eot,0,0,0
29f691d,{'file_name': '29f691d'},ttf,0,0,0
c6dff51,{'file_name': 'c6dff51'},woff,0,0,0
bb19504,{'file_name': 'bb19504'},woff2,0,0,0
3d41549,{'file_name': '3d41549'},eot,0,0,0
f402040,{'file_name': 'f402040'},ttf,0,0,0
88ad05b,{'file_name': '88ad05b'},woff,0,0,0
c4e3d80,{'file_name': 'c4e3d80'},woff2,0,0,0
3f82642,{'file_name': '3f82642'},eot,0,0,0
b4bfc9b,{'file_name': 'b4bfc9b'},ttf,0,0,0
76114bc,{'file_name': '76114bc'},woff,0,0,0
3404f37,{'file_name': '3404f37'},woff2,0,0,0
11e3f2a,{'file_name': '11e3f2a'},eot,0,0,0
74decd9,{'file_name': '74decd9'},ttf,0,0,0
ae1307f,{'file_name': 'ae1307f'},woff,0,0,0
3bf9843,{'file_name': '3bf9843'},woff2,0,0,0
df5d1df,{'file_name': 'df5d1df'},ttf,0,0,0
eb52a79,{'file_name': 'eb52a79'},ttf,0,0,0
79dc8ef,{'file_name': '79dc8ef'},eot,0,0,0
df5d1df,{'file_name': 'df5d1df'},ttf,0,0,0
6cb6000,{'file_name': '6cb6000'},woff,0,0,0
7059e23,{'file_name': '7059e23'},woff2,0,0,0
2f7ca78,{'file_name': '2f7ca78'},eot,0,0,0
eb52a79,{'file_name': 'eb52a79'},ttf,0,0,0
f815f63,{'file_name': 'f815f63'},woff,0,0,0
f2c76e5,{'file_name': 'f2c76e5'},woff2,0,0,0
e9f60ca,{'file_name': 'e9f60ca'},eot,0,0,0
855c845,{'file_name': '855c845'},svg,0,2671,2671
35acda2,{'file_name': '35acda2'},ttf,0,0,0
400014a,{'file_name': '400014a'},woff,0,0,0
4d13fc6,{'file_name': '4d13fc6'},woff2,0,0,0
5093733,{'file_name': '5093733'},js,0,10872,10872
b061403,{'file_name': 'b061403'},js,0,2,2
526d723,{'file_name': '526d723'},js,0,1,1
2b43bd0,{'file_name': '2b43bd0'},js,0,4,4
cd1c674,{'file_name': 'cd1c674'},js,0,4,4
f65d479,{'file_name': 'f65d479'},js,0,4,4
839d07e,{'file_name': '839d07e'},js,0,1,1
863704b,{'file_name': '863704b'},js,0,297,297
d96755f,{'file_name': 'd96755f'},png,0,0,0
7107cec,{'file_name': '7107cec'},png,0,0,0
582d5c3,{'file_name': '582d5c3'},css,0,74,74
e09f926,{'file_name': 'e09f926'},js,0,522,522
ffd77af,{'file_name': 'ffd77af'},js,0,2042,2042
cf177d4,{'file_name': 'cf177d4'},js,0,6,6
6d2ac02,{'file_name': '6d2ac02'},html,0,204,204
17d3bf9,{'file_name': '17d3bf9'},html,0,217,217
943eab2,{'file_name': '943eab2'},inv,0,0,0
ce4b36d,{'file_name': 'ce4b36d'},html,0,214,214
ab80add,{'file_name': 'ab80add'},html,0,334,334
73605a3,{'file_name': '73605a3'},html,0,411,411
bf42f41,{'file_name': 'bf42f41'},html,0,308,308
9c46082,{'file_name': '9c46082'},html,0,321,321
64737a4,{'file_name': '64737a4'},html,0,206,206
5d76e86,{'file_name': '5d76e86'},html,0,243,243
4afe672,{'file_name': '4afe672'},html,0,229,229
2411557,{'file_name': '2411557'},html,0,215,215
6fd4640,{'file_name': '6fd4640'},html,0,214,214
4c7ce3c,{'file_name': '4c7ce3c'},html,0,265,265
4077558,{'file_name': '4077558'},html,0,297,297
11e86b2,{'file_name': '11e86b2'},html,0,215,215
6e3a531,{'file_name': '6e3a531'},html,0,241,241
b968c33,{'file_name': 'b968c33'},html,0,303,303
89b6314,{'file_name': '89b6314'},html,0,235,235
1a3f916,{'file_name': '1a3f916'},html,0,223,223
d48726f,{'file_name': 'd48726f'},html,0,234,234
cf1716e,{'file_name': 'cf1716e'},html,0,237,237
bb50a6e,{'file_name': 'bb50a6e'},html,0,218,218
194a8a1,{'file_name': '194a8a1'},html,0,206,206
f5dcda3,{'file_name': 'f5dcda3'},html,0,339,339
2a2d62a,{'file_name': '2a2d62a'},html,0,225,225
2b2631f,{'file_name': '2b2631f'},html,0,228,228
6e2eb14,{'file_name': '6e2eb14'},html,0,238,238
3fcf524,{'file_name': '3fcf524'},html,0,241,241
ad8c49a,{'file_name': 'ad8c49a'},html,0,254,254
e357e43,{'file_name': 'e357e43'},html,0,278,278
2caf757,{'file_name': '2caf757'},html,0,208,208
b776b8c,{'file_name': 'b776b8c'},html,0,236,236
edb5868,{'file_name': 'edb5868'},html,0,230,230
3ff4ec4,{'file_name': '3ff4ec4'},html,0,250,250
001bb7b,{'file_name': '001bb7b'},html,0,400,400
e82f8f8,{'file_name': 'e82f8f8'},html,0,213,213
1db4fda,{'file_name': '1db4fda'},html,0,213,213
1f803a1,{'file_name': '1f803a1'},html,0,213,213
14fd52b,{'file_name': '14fd52b'},html,0,213,213
d784b4b,{'file_name': 'd784b4b'},html,0,213,213
a6ebdf9,{'file_name': 'a6ebdf9'},html,0,213,213
5a6d209,{'file_name': '5a6d209'},html,0,213,213
9ce183f,{'file_name': '9ce183f'},html,0,270,270
68c91bd,{'file_name': '68c91bd'},html,0,213,213
59efb74,{'file_name': '59efb74'},html,0,213,213
243c2ea,{'file_name': '243c2ea'},html,0,213,213
e7723fa,{'file_name': 'e7723fa'},html,0,213,213
ffe3233,{'file_name': 'ffe3233'},html,0,213,213
d35c25c,{'file_name': 'd35c25c'},html,0,226,226
5b62b8c,{'file_name': '5b62b8c'},html,0,213,213
01e510b,{'file_name': '01e510b'},html,0,213,213
ab2aecd,{'file_name': 'ab2aecd'},html,0,213,213
9d300bd,{'file_name': '9d300bd'},html,0,0,0
9c31b27,{'file_name': '9c31b27'},html,0,206,206
190a21a,{'file_name': '190a21a'},html,0,209,209
8936c22,{'file_name': '8936c22'},html,0,213,213
8c0699c,{'file_name': '8c0699c'},html,0,213,213
40ac180,{'file_name': '40ac180'},html,0,213,213
5de8cba,{'file_name': '5de8cba'},html,0,213,213
8801e3e,{'file_name': '8801e3e'},html,0,213,213
ec2d1c9,{'file_name': 'ec2d1c9'},html,0,251,251
82f82fb,{'file_name': '82f82fb'},html,0,217,217
64c7c06,{'file_name': '64c7c06'},js,0,1,1
4ac4b44,{'file_name': '4ac4b44'},py,7,8,15
64fe4b7,{'file_name': '64fe4b7'},py,24,23,47
10a96b5,{'file_name': '10a96b5'},py,0,2,2
5881bed,{'file_name': '5881bed'},py,7,11,18
91aca72,{'file_name': '91aca72'},py,4,4,8
e12aae3,{'file_name': 'e12aae3'},py,23,32,55
c42ab16,{'file_name': 'c42ab16'},py,9,5,14
95cdc43,{'file_name': '95cdc43'},py,9,6,15
f283618,{'file_name': 'f283618'},py,8,13,21
51c148a,{'file_name': '51c148a'},py,7,10,17
0029314,{'file_name': '0029314'},rst,4,8,12
b6fb85f,{'file_name': 'b6fb85f'},py,1,3,4
bda69bb,{'file_name': 'bda69bb'},png,0,0,0
ca58f6e,{'file_name': 'ca58f6e'},gitignore,1,0,1
482933b,{'file_name': '482933b'},pickle,0,0,0
d4e7b2e,{'file_name': 'd4e7b2e'},doctree,0,0,0
d475c7f,{'file_name': 'd475c7f'},doctree,0,0,0
afd2e6e,{'file_name': 'afd2e6e'},doctree,0,0,0
becd071,{'file_name': 'becd071'},doctree,0,0,0
44843db,{'file_name': '44843db'},buildinfo,1,1,2
379cdaf,{'file_name': '379cdaf'},txt,5,4,9
e380325,{'file_name': 'e380325'},css,1,1,2
6cb6000,{'file_name': '6cb6000'},woff,0,0,0
7059e23,{'file_name': '7059e23'},woff2,0,0,0
f815f63,{'file_name': 'f815f63'},woff,0,0,0
f2c76e5,{'file_name': 'f2c76e5'},woff2,0,0,0
e9f60ca,{'file_name': 'e9f60ca'},eot,0,0,0
855c845,{'file_name': '855c845'},svg,2671,0,2671
35acda2,{'file_name': '35acda2'},ttf,0,0,0
400014a,{'file_name': '400014a'},woff,0,0,0
4d13fc6,{'file_name': '4d13fc6'},woff2,0,0,0
88ad05b,{'file_name': '88ad05b'},woff,0,0,0
c4e3d80,{'file_name': 'c4e3d80'},woff2,0,0,0
c6dff51,{'file_name': 'c6dff51'},woff,0,0,0
bb19504,{'file_name': 'bb19504'},woff2,0,0,0
76114bc,{'file_name': '76114bc'},woff,0,0,0
3404f37,{'file_name': '3404f37'},woff2,0,0,0
ae1307f,{'file_name': 'ae1307f'},woff,0,0,0
3bf9843,{'file_name': '3bf9843'},woff2,0,0,0
8cd4f10,{'file_name': '8cd4f10'},css,2,4,6
401ec0f,{'file_name': '401ec0f'},otf,0,0,0
6cb6000,{'file_name': '6cb6000'},woff,0,0,0
7059e23,{'file_name': '7059e23'},woff2,0,0,0
337d287,{'file_name': '337d287'},woff,0,0,0
20398af,{'file_name': '20398af'},woff2,0,0,0
f815f63,{'file_name': 'f815f63'},woff,0,0,0
f2c76e5,{'file_name': 'f2c76e5'},woff2,0,0,0
6b30ea6,{'file_name': '6b30ea6'},woff,0,0,0
328f5bb,{'file_name': '328f5bb'},woff2,0,0,0
88ad05b,{'file_name': '88ad05b'},woff,0,0,0
c4e3d80,{'file_name': 'c4e3d80'},woff2,0,0,0
c6dff51,{'file_name': 'c6dff51'},woff,0,0,0
bb19504,{'file_name': 'bb19504'},woff2,0,0,0
76114bc,{'file_name': '76114bc'},woff,0,0,0
3404f37,{'file_name': '3404f37'},woff2,0,0,0
ae1307f,{'file_name': 'ae1307f'},woff,0,0,0
3bf9843,{'file_name': '3bf9843'},woff2,0,0,0
526d723,{'file_name': '526d723'},js,1,0,1
2b43bd0,{'file_name': '2b43bd0'},js,4,0,4
cd1c674,{'file_name': 'cd1c674'},js,4,0,4
839d07e,{'file_name': '839d07e'},js,1,3,4
a535abd,{'file_name': 'a535abd'},html,21,11,32
481551c,{'file_name': '481551c'},html,21,11,32
fa521e0,{'file_name': 'fa521e0'},html,21,11,32
1f5a949,{'file_name': '1f5a949'},html,27,16,43
dea7e36,{'file_name': 'dea7e36'},html,24,14,38
5e17b81,{'file_name': '5e17b81'},js,1,1,2
1810347,{'file_name': '1810347'},html,21,11,32
379cdaf,{'file_name': '379cdaf'},rst,4,3,7
9187b8d,{'file_name': '9187b8d'},Pipfile,13,0,13
1bfa95d,{'file_name': '1bfa95d'},lock,210,0,210
f64a3ec,{'file_name': 'f64a3ec'},py,1,1,2
e5ec85b,{'file_name': 'e5ec85b'},md,1,1,2
26596bd,{'file_name': '26596bd'},rst,4,4,8
48ca556,{'file_name': '48ca556'},mod,0,5,5
5093829,{'file_name': '5093829'},py,0,28,28
e69de29,{'file_name': 'e69de29'},py,0,0,0
e69de29,{'file_name': 'e69de29'},py,0,0,0
e69de29,{'file_name': 'e69de29'},py,0,0,0
a650bca,{'file_name': 'a650bca'},py,1,1,2
e69de29,{'file_name': 'e69de29'},py,0,0,0
ccf0d91,{'file_name': 'ccf0d91'},py,1,1,2
be08de5,{'file_name': 'be08de5'},py,1,1,2
e69de29,{'file_name': 'e69de29'},py,0,0,0
7cc4365,{'file_name': '7cc4365'},py,0,0,0
8732629,{'file_name': '8732629'},py,0,0,0
f8e055c,{'file_name': 'f8e055c'},py,0,0,0
f51d655,{'file_name': 'f51d655'},py,0,0,0
da01e38,{'file_name': 'da01e38'},py,0,0,0
fe7edba,{'file_name': 'fe7edba'},py,0,0,0
03f6ac3,{'file_name': '03f6ac3'},py,0,0,0
e69de29,{'file_name': 'e69de29'},py,0,0,0
03847c2,{'file_name': '03847c2'},py,0,0,0
69eb68f,{'file_name': '69eb68f'},py,0,0,0
93b4423,{'file_name': '93b4423'},jpg,0,0,0
40bba92,{'file_name': '40bba92'},py,1,1,2
86feb5d,{'file_name': '86feb5d'},py,0,0,0
c5d415f,{'file_name': 'c5d415f'},py,2,2,4
e69de29,{'file_name': 'e69de29'},py,0,0,0
a954b80,{'file_name': 'a954b80'},py,0,0,0
f2af251,{'file_name': 'f2af251'},py,0,0,0
8e6183a,{'file_name': '8e6183a'},py,0,0,0
08f5d37,{'file_name': '08f5d37'},py,0,0,0
28dce88,{'file_name': '28dce88'},md,0,0,0
0cc5562,{'file_name': '0cc5562'},py,0,0,0
e69de29,{'file_name': 'e69de29'},py,0,0,0
46fd49f,{'file_name': '46fd49f'},py,0,0,0
2d4e823,{'file_name': '2d4e823'},png,0,0,0
d25b0c8,{'file_name': 'd25b0c8'},png,0,0,0
c37046b,{'file_name': 'c37046b'},png,0,0,0
81deb74,{'file_name': '81deb74'},png,0,0,0
b0f43f2,{'file_name': 'b0f43f2'},png,0,0,0
4d95013,{'file_name': '4d95013'},png,0,0,0
070e4aa,{'file_name': '070e4aa'},png,0,0,0
87f784b,{'file_name': '87f784b'},png,0,0,0
20d809e,{'file_name': '20d809e'},png,0,0,0
c8dd7ad,{'file_name': 'c8dd7ad'},png,0,0,0
24caeec,{'file_name': '24caeec'},png,0,0,0
5e96f18,{'file_name': '5e96f18'},png,0,0,0
d4cd4ad,{'file_name': 'd4cd4ad'},png,0,0,0
2d921b2,{'file_name': '2d921b2'},psd,0,0,0
2d9d2e5,{'file_name': '2d9d2e5'},png,0,0,0
5ade957,{'file_name': '5ade957'},png,0,0,0
2ead35e,{'file_name': '2ead35e'},qss,0,0,0
367ca0a,{'file_name': '367ca0a'},qss,0,0,0
581cb2d,{'file_name': '581cb2d'},ui,0,0,0
7cece1a,{'file_name': '7cece1a'},py,0,0,0
1325944,{'file_name': '1325944'},rst,1,1,2
e69de29,{'file_name': 'e69de29'},py,0,36,36
6c3ce4c,{'file_name': '6c3ce4c'},py,40,0,40
c37046b,{'file_name': 'c37046b'},png,0,0,0
fb4221f,{'file_name': 'fb4221f'},png,0,0,0
e69de29,{'file_name': 'e69de29'},py,0,0,0
b5aa3eb,{'file_name': 'b5aa3eb'},py,1,1,2
3e25a1d,{'file_name': '3e25a1d'},py,1,1,2
e69de29,{'file_name': 'e69de29'},py,0,0,0
7cc4365,{'file_name': '7cc4365'},py,0,0,0
8732629,{'file_name': '8732629'},py,0,0,0
f8e055c,{'file_name': 'f8e055c'},py,0,0,0
f51d655,{'file_name': 'f51d655'},py,0,0,0
da01e38,{'file_name': 'da01e38'},py,0,0,0
fe7edba,{'file_name': 'fe7edba'},py,0,0,0
03f6ac3,{'file_name': '03f6ac3'},py,0,0,0
e69de29,{'file_name': 'e69de29'},py,0,0,0
03847c2,{'file_name': '03847c2'},py,0,0,0
69eb68f,{'file_name': '69eb68f'},py,0,0,0
93b4423,{'file_name': '93b4423'},jpg,0,0,0
67e8746,{'file_name': '67e8746'},py,1,1,2
86feb5d,{'file_name': '86feb5d'},py,0,0,0
3fce6fe,{'file_name': '3fce6fe'},py,2,2,4
e69de29,{'file_name': 'e69de29'},py,0,0,0
a954b80,{'file_name': 'a954b80'},py,0,0,0
f2af251,{'file_name': 'f2af251'},py,0,0,0
8e6183a,{'file_name': '8e6183a'},py,0,0,0
08f5d37,{'file_name': '08f5d37'},py,0,0,0
0cc5562,{'file_name': '0cc5562'},py,1,1,2
28dce88,{'file_name': '28dce88'},md,0,0,0
e69de29,{'file_name': 'e69de29'},py,0,0,0
46fd49f,{'file_name': '46fd49f'},py,0,0,0
2d4e823,{'file_name': '2d4e823'},png,0,0,0
d25b0c8,{'file_name': 'd25b0c8'},png,0,0,0
81deb74,{'file_name': '81deb74'},png,0,0,0
b0f43f2,{'file_name': 'b0f43f2'},png,0,0,0
4d95013,{'file_name': '4d95013'},png,0,0,0
070e4aa,{'file_name': '070e4aa'},png,0,0,0
87f784b,{'file_name': '87f784b'},png,0,0,0
20d809e,{'file_name': '20d809e'},png,0,0,0
c8dd7ad,{'file_name': 'c8dd7ad'},png,0,0,0
24caeec,{'file_name': '24caeec'},png,0,0,0
5e96f18,{'file_name': '5e96f18'},png,0,0,0
d4cd4ad,{'file_name': 'd4cd4ad'},png,0,0,0
2d921b2,{'file_name': '2d921b2'},psd,0,0,0
2d9d2e5,{'file_name': '2d9d2e5'},png,0,0,0
5ade957,{'file_name': '5ade957'},png,0,0,0
2ead35e,{'file_name': '2ead35e'},qss,0,0,0
367ca0a,{'file_name': '367ca0a'},qss,0,0,0
581cb2d,{'file_name': '581cb2d'},ui,0,0,0
7cece1a,{'file_name': '7cece1a'},py,4,3,7
06bc413,{'file_name': '06bc413'},md,6,23,29
d500f4b,{'file_name': 'd500f4b'},pickle,0,0,0
7674548,{'file_name': '7674548'},doctree,0,0,0
5f06022,{'file_name': '5f06022'},doctree,0,0,0
4f7ddd1,{'file_name': '4f7ddd1'},doctree,0,0,0
de7008c,{'file_name': 'de7008c'},doctree,0,0,0
18ada79,{'file_name': '18ada79'},txt,1,1,2
4b6f463,{'file_name': '4b6f463'},txt,2,3,5
5e8c591,{'file_name': '5e8c591'},txt,2,2,4
21fb570,{'file_name': '21fb570'},txt,3,3,6
fd548c1,{'file_name': 'fd548c1'},html,0,1,1
16dd976,{'file_name': '16dd976'},html,1,2,3
c4bf120,{'file_name': 'c4bf120'},html,5,10,15
92e0ba3,{'file_name': '92e0ba3'},html,4,5,9
1ab4042,{'file_name': '1ab4042'},inv,0,0,0
ed4b15a,{'file_name': 'ed4b15a'},html,0,1,1
80a21f9,{'file_name': '80a21f9'},js,1,1,2
153b9b2,{'file_name': '153b9b2'},html,3,7,10
56c32b6,{'file_name': '56c32b6'},rst,0,9,9
18ada79,{'file_name': '18ada79'},rst,1,1,2
4b6f463,{'file_name': '4b6f463'},rst,2,3,5
5e8c591,{'file_name': '5e8c591'},rst,2,2,4
21fb570,{'file_name': '21fb570'},rst,3,3,6
a33705d,{'file_name': 'a33705d'},md,7,1,8
ccf0d91,{'file_name': 'ccf0d91'},py,92,0,92
be08de5,{'file_name': 'be08de5'},py,213,0,213
7cc4365,{'file_name': '7cc4365'},py,92,0,92
03f6ac3,{'file_name': '03f6ac3'},py,56,0,56
c5d415f,{'file_name': 'c5d415f'},py,156,0,156
f51d655,{'file_name': 'f51d655'},py,0,1,1
a954b80,{'file_name': 'a954b80'},py,7,1,8
26305ef,{'file_name': '26305ef'},py,8,12,20
3e865c2,{'file_name': '3e865c2'},py,36,0,36
69eb68f,{'file_name': '69eb68f'},py,3,5,8
592c84a,{'file_name': '592c84a'},py,0,21,21
581cb2d,{'file_name': '581cb2d'},ui,0,1,1
28dce88,{'file_name': '28dce88'},md,2,0,2
5093829,{'file_name': '5093829'},py,7,16,23
389e842,{'file_name': '389e842'},py,0,67,67
d082c89,{'file_name': 'd082c89'},ini,0,17,17
48ca556,{'file_name': '48ca556'},mod,5,0,5
9aff6d6,{'file_name': '9aff6d6'},json,0,16,16
6f1c0fc,{'file_name': '6f1c0fc'},ma,0,84,84
52e6694,{'file_name': '52e6694'},json,0,16,16
4defd9a,{'file_name': '4defd9a'},ma,0,86,86
6ef6fb8,{'file_name': '6ef6fb8'},json,0,16,16
04379c0,{'file_name': '04379c0'},ma,0,82,82
2036aa9,{'file_name': '2036aa9'},json,0,16,16
64f605b,{'file_name': '64f605b'},ma,0,83,83
67e4b27,{'file_name': '67e4b27'},png,0,0,0
b130671,{'file_name': 'b130671'},json,0,16,16
66314cc,{'file_name': '66314cc'},ma,0,237,237
37078f3,{'file_name': '37078f3'},png,0,0,0
d8bdf1b,{'file_name': 'd8bdf1b'},ma,0,237,237
2c54eed,{'file_name': '2c54eed'},png,0,0,0
75ebd78,{'file_name': '75ebd78'},json,0,16,16
5c9ea6f,{'file_name': '5c9ea6f'},json,0,16,16
3c98644,{'file_name': '3c98644'},ma,0,82,82
3533805,{'file_name': '3533805'},ma,0,0,0
e956113,{'file_name': 'e956113'},json,2,2,4
7e611c8,{'file_name': '7e611c8'},ma,0,0,0
7d5c9d0,{'file_name': '7d5c9d0'},png,0,0,0
e8d1330,{'file_name': 'e8d1330'},json,1,1,2
60703e5,{'file_name': '60703e5'},ma,0,0,0
263eac9,{'file_name': '263eac9'},png,0,0,0
985e9eb,{'file_name': '985e9eb'},json,2,2,4
1a01782,{'file_name': '1a01782'},ma,0,0,0
de0304e,{'file_name': 'de0304e'},png,0,0,0
e69de29,{'file_name': 'e69de29'},py,0,0,0
e69de29,{'file_name': 'e69de29'},py,0,0,0
e69de29,{'file_name': 'e69de29'},py,0,0,0
e69de29,{'file_name': 'e69de29'},py,0,0,0
8732629,{'file_name': '8732629'},py,0,0,0
f8e055c,{'file_name': 'f8e055c'},py,0,0,0
da01e38,{'file_name': 'da01e38'},py,0,0,0
fe7edba,{'file_name': 'fe7edba'},py,0,0,0
e69de29,{'file_name': 'e69de29'},py,0,0,0
03847c2,{'file_name': '03847c2'},py,0,0,0
93b4423,{'file_name': '93b4423'},jpg,0,0,0
40bba92,{'file_name': '40bba92'},py,0,0,0
86feb5d,{'file_name': '86feb5d'},py,0,0,0
e69de29,{'file_name': 'e69de29'},py,0,0,0
f2af251,{'file_name': 'f2af251'},py,0,0,0
8e6183a,{'file_name': '8e6183a'},py,0,0,0
08f5d37,{'file_name': '08f5d37'},py,0,0,0
e69de29,{'file_name': 'e69de29'},py,0,0,0
46fd49f,{'file_name': '46fd49f'},py,0,0,0
2d4e823,{'file_name': '2d4e823'},png,0,0,0
d25b0c8,{'file_name': 'd25b0c8'},png,0,0,0
fb4221f,{'file_name': 'fb4221f'},png,0,0,0
81deb74,{'file_name': '81deb74'},png,0,0,0
b0f43f2,{'file_name': 'b0f43f2'},png,0,0,0
4d95013,{'file_name': '4d95013'},png,0,0,0
070e4aa,{'file_name': '070e4aa'},png,0,0,0
87f784b,{'file_name': '87f784b'},png,0,0,0
20d809e,{'file_name': '20d809e'},png,0,0,0
c8dd7ad,{'file_name': 'c8dd7ad'},png,0,0,0
24caeec,{'file_name': '24caeec'},png,0,0,0
5e96f18,{'file_name': '5e96f18'},png,0,0,0
d4cd4ad,{'file_name': 'd4cd4ad'},png,0,0,0
2d921b2,{'file_name': '2d921b2'},psd,0,0,0
2d9d2e5,{'file_name': '2d9d2e5'},png,0,0,0
5ade957,{'file_name': '5ade957'},png,0,0,0
2ead35e,{'file_name': '2ead35e'},qss,0,0,0
367ca0a,{'file_name': '367ca0a'},qss,0,0,0
cb40e77,{'file_name': 'cb40e77'},py,0,0,0
2bcf7d8,{'file_name': '2bcf7d8'},py,0,93,93
3f0634b,{'file_name': '3f0634b'},py,0,211,211
5f3e777,{'file_name': '5f3e777'},py,0,93,93
8117f06,{'file_name': '8117f06'},py,0,66,66
a528b19,{'file_name': 'a528b19'},py,0,156,156
b8e0509,{'file_name': 'b8e0509'},pickle,0,0,0
ee85328,{'file_name': 'ee85328'},doctree,0,0,0
3766e2a,{'file_name': '3766e2a'},txt,12,2,14
3b21512,{'file_name': '3b21512'},html,1,0,1
053d6b1,{'file_name': '053d6b1'},html,11,2,13
d5b5b34,{'file_name': 'd5b5b34'},js,1,1,2
3766e2a,{'file_name': '3766e2a'},rst,12,2,14
e1efb7d,{'file_name': 'e1efb7d'},pickle,0,0,0
dd9e065,{'file_name': 'dd9e065'},doctree,0,0,0
b854900,{'file_name': 'b854900'},txt,1,1,2
fecd127,{'file_name': 'fecd127'},html,1,1,2
b854900,{'file_name': 'b854900'},rst,1,1,2
d218945,{'file_name': 'd218945'},pickle,0,0,0
b09ecd7,{'file_name': 'b09ecd7'},doctree,0,0,0
370a7e8,{'file_name': '370a7e8'},txt,2,2,4
3be2a76,{'file_name': '3be2a76'},html,2,2,4
7cde80f,{'file_name': '7cde80f'},lock,48,36,84
b6fb85f,{'file_name': 'b6fb85f'},py,1,3,4
bda69bb,{'file_name': 'bda69bb'},png,0,0,0
ca58f6e,{'file_name': 'ca58f6e'},gitignore,1,0,1
482933b,{'file_name': '482933b'},pickle,0,0,0
d4e7b2e,{'file_name': 'd4e7b2e'},doctree,0,0,0
d475c7f,{'file_name': 'd475c7f'},doctree,0,0,0
afd2e6e,{'file_name': 'afd2e6e'},doctree,0,0,0
becd071,{'file_name': 'becd071'},doctree,0,0,0
44843db,{'file_name': '44843db'},buildinfo,1,1,2
379cdaf,{'file_name': '379cdaf'},txt,5,4,9
e380325,{'file_name': 'e380325'},css,1,1,2
6cb6000,{'file_name': '6cb6000'},woff,0,0,0
7059e23,{'file_name': '7059e23'},woff2,0,0,0
f815f63,{'file_name': 'f815f63'},woff,0,0,0
f2c76e5,{'file_name': 'f2c76e5'},woff2,0,0,0
e9f60ca,{'file_name': 'e9f60ca'},eot,0,0,0
855c845,{'file_name': '855c845'},svg,2671,0,2671
35acda2,{'file_name': '35acda2'},ttf,0,0,0
400014a,{'file_name': '400014a'},woff,0,0,0
4d13fc6,{'file_name': '4d13fc6'},woff2,0,0,0
88ad05b,{'file_name': '88ad05b'},woff,0,0,0
c4e3d80,{'file_name': 'c4e3d80'},woff2,0,0,0
c6dff51,{'file_name': 'c6dff51'},woff,0,0,0
bb19504,{'file_name': 'bb19504'},woff2,0,0,0
76114bc,{'file_name': '76114bc'},woff,0,0,0
3404f37,{'file_name': '3404f37'},woff2,0,0,0
ae1307f,{'file_name': 'ae1307f'},woff,0,0,0
3bf9843,{'file_name': '3bf9843'},woff2,0,0,0
8cd4f10,{'file_name': '8cd4f10'},css,2,4,6
401ec0f,{'file_name': '401ec0f'},otf,0,0,0
6cb6000,{'file_name': '6cb6000'},woff,0,0,0
7059e23,{'file_name': '7059e23'},woff2,0,0,0
337d287,{'file_name': '337d287'},woff,0,0,0
20398af,{'file_name': '20398af'},woff2,0,0,0
f815f63,{'file_name': 'f815f63'},woff,0,0,0
f2c76e5,{'file_name': 'f2c76e5'},woff2,0,0,0
6b30ea6,{'file_name': '6b30ea6'},woff,0,0,0
328f5bb,{'file_name': '328f5bb'},woff2,0,0,0
88ad05b,{'file_name': '88ad05b'},woff,0,0,0
c4e3d80,{'file_name': 'c4e3d80'},woff2,0,0,0
c6dff51,{'file_name': 'c6dff51'},woff,0,0,0
bb19504,{'file_name': 'bb19504'},woff2,0,0,0
76114bc,{'file_name': '76114bc'},woff,0,0,0
3404f37,{'file_name': '3404f37'},woff2,0,0,0
ae1307f,{'file_name': 'ae1307f'},woff,0,0,0
3bf9843,{'file_name': '3bf9843'},woff2,0,0,0
526d723,{'file_name': '526d723'},js,1,0,1
2b43bd0,{'file_name': '2b43bd0'},js,4,0,4
cd1c674,{'file_name': 'cd1c674'},js,4,0,4
839d07e,{'file_name': '839d07e'},js,1,3,4
a535abd,{'file_name': 'a535abd'},html,21,11,32
481551c,{'file_name': '481551c'},html,21,11,32
fa521e0,{'file_name': 'fa521e0'},html,21,11,32
1f5a949,{'file_name': '1f5a949'},html,27,16,43
dea7e36,{'file_name': 'dea7e36'},html,24,14,38
5e17b81,{'file_name': '5e17b81'},js,1,1,2
1810347,{'file_name': '1810347'},html,21,11,32
379cdaf,{'file_name': '379cdaf'},rst,4,3,7
9187b8d,{'file_name': '9187b8d'},Pipfile,13,0,13
1bfa95d,{'file_name': '1bfa95d'},lock,210,0,210
f64a3ec,{'file_name': 'f64a3ec'},py,1,1,2
e5ec85b,{'file_name': 'e5ec85b'},md,1,1,2
26596bd,{'file_name': '26596bd'},rst,4,4,8
48ca556,{'file_name': '48ca556'},mod,0,5,5
5093829,{'file_name': '5093829'},py,0,28,28
e69de29,{'file_name': 'e69de29'},py,0,0,0
e69de29,{'file_name': 'e69de29'},py,0,0,0
e69de29,{'file_name': 'e69de29'},py,0,0,0
a650bca,{'file_name': 'a650bca'},py,1,1,2
e69de29,{'file_name': 'e69de29'},py,0,0,0
ccf0d91,{'file_name': 'ccf0d91'},py,1,1,2
be08de5,{'file_name': 'be08de5'},py,1,1,2
e69de29,{'file_name': 'e69de29'},py,0,0,0
7cc4365,{'file_name': '7cc4365'},py,0,0,0
8732629,{'file_name': '8732629'},py,0,0,0
f8e055c,{'file_name': 'f8e055c'},py,0,0,0
f51d655,{'file_name': 'f51d655'},py,0,0,0
da01e38,{'file_name': 'da01e38'},py,0,0,0
fe7edba,{'file_name': 'fe7edba'},py,0,0,0
03f6ac3,{'file_name': '03f6ac3'},py,0,0,0
e69de29,{'file_name': 'e69de29'},py,0,0,0
03847c2,{'file_name': '03847c2'},py,0,0,0
69eb68f,{'file_name': '69eb68f'},py,0,0,0
93b4423,{'file_name': '93b4423'},jpg,0,0,0
40bba92,{'file_name': '40bba92'},py,1,1,2
86feb5d,{'file_name': '86feb5d'},py,0,0,0
c5d415f,{'file_name': 'c5d415f'},py,2,2,4
e69de29,{'file_name': 'e69de29'},py,0,0,0
a954b80,{'file_name': 'a954b80'},py,0,0,0
f2af251,{'file_name': 'f2af251'},py,0,0,0
8e6183a,{'file_name': '8e6183a'},py,0,0,0
08f5d37,{'file_name': '08f5d37'},py,0,0,0
28dce88,{'file_name': '28dce88'},md,0,0,0
0cc5562,{'file_name': '0cc5562'},py,0,0,0
e69de29,{'file_name': 'e69de29'},py,0,0,0
46fd49f,{'file_name': '46fd49f'},py,0,0,0
2d4e823,{'file_name': '2d4e823'},png,0,0,0
d25b0c8,{'file_name': 'd25b0c8'},png,0,0,0
c37046b,{'file_name': 'c37046b'},png,0,0,0
81deb74,{'file_name': '81deb74'},png,0,0,0
b0f43f2,{'file_name': 'b0f43f2'},png,0,0,0
4d95013,{'file_name': '4d95013'},png,0,0,0
070e4aa,{'file_name': '070e4aa'},png,0,0,0
87f784b,{'file_name': '87f784b'},png,0,0,0
20d809e,{'file_name': '20d809e'},png,0,0,0
c8dd7ad,{'file_name': 'c8dd7ad'},png,0,0,0
24caeec,{'file_name': '24caeec'},png,0,0,0
5e96f18,{'file_name': '5e96f18'},png,0,0,0
d4cd4ad,{'file_name': 'd4cd4ad'},png,0,0,0
2d921b2,{'file_name': '2d921b2'},psd,0,0,0
2d9d2e5,{'file_name': '2d9d2e5'},png,0,0,0
5ade957,{'file_name': '5ade957'},png,0,0,0
2ead35e,{'file_name': '2ead35e'},qss,0,0,0
367ca0a,{'file_name': '367ca0a'},qss,0,0,0
581cb2d,{'file_name': '581cb2d'},ui,0,0,0
7cece1a,{'file_name': '7cece1a'},py,0,0,0
1325944,{'file_name': '1325944'},rst,1,1,2
e69de29,{'file_name': 'e69de29'},py,0,36,36
6c3ce4c,{'file_name': '6c3ce4c'},py,40,0,40
c37046b,{'file_name': 'c37046b'},png,0,0,0
fb4221f,{'file_name': 'fb4221f'},png,0,0,0
e69de29,{'file_name': 'e69de29'},py,0,0,0
b5aa3eb,{'file_name': 'b5aa3eb'},py,1,1,2
3e25a1d,{'file_name': '3e25a1d'},py,1,1,2
e69de29,{'file_name': 'e69de29'},py,0,0,0
7cc4365,{'file_name': '7cc4365'},py,0,0,0
8732629,{'file_name': '8732629'},py,0,0,0
f8e055c,{'file_name': 'f8e055c'},py,0,0,0
f51d655,{'file_name': 'f51d655'},py,0,0,0
da01e38,{'file_name': 'da01e38'},py,0,0,0
fe7edba,{'file_name': 'fe7edba'},py,0,0,0
03f6ac3,{'file_name': '03f6ac3'},py,0,0,0
e69de29,{'file_name': 'e69de29'},py,0,0,0
03847c2,{'file_name': '03847c2'},py,0,0,0
69eb68f,{'file_name': '69eb68f'},py,0,0,0
93b4423,{'file_name': '93b4423'},jpg,0,0,0
67e8746,{'file_name': '67e8746'},py,1,1,2
86feb5d,{'file_name': '86feb5d'},py,0,0,0
3fce6fe,{'file_name': '3fce6fe'},py,2,2,4
e69de29,{'file_name': 'e69de29'},py,0,0,0
a954b80,{'file_name': 'a954b80'},py,0,0,0
f2af251,{'file_name': 'f2af251'},py,0,0,0
8e6183a,{'file_name': '8e6183a'},py,0,0,0
08f5d37,{'file_name': '08f5d37'},py,0,0,0
0cc5562,{'file_name': '0cc5562'},py,1,1,2
28dce88,{'file_name': '28dce88'},md,0,0,0
e69de29,{'file_name': 'e69de29'},py,0,0,0
46fd49f,{'file_name': '46fd49f'},py,0,0,0
2d4e823,{'file_name': '2d4e823'},png,0,0,0
d25b0c8,{'file_name': 'd25b0c8'},png,0,0,0
81deb74,{'file_name': '81deb74'},png,0,0,0
b0f43f2,{'file_name': 'b0f43f2'},png,0,0,0
4d95013,{'file_name': '4d95013'},png,0,0,0
070e4aa,{'file_name': '070e4aa'},png,0,0,0
87f784b,{'file_name': '87f784b'},png,0,0,0
20d809e,{'file_name': '20d809e'},png,0,0,0
c8dd7ad,{'file_name': 'c8dd7ad'},png,0,0,0
24caeec,{'file_name': '24caeec'},png,0,0,0
5e96f18,{'file_name': '5e96f18'},png,0,0,0
d4cd4ad,{'file_name': 'd4cd4ad'},png,0,0,0
2d921b2,{'file_name': '2d921b2'},psd,0,0,0
2d9d2e5,{'file_name': '2d9d2e5'},png,0,0,0
5ade957,{'file_name': '5ade957'},png,0,0,0
2ead35e,{'file_name': '2ead35e'},qss,0,0,0
367ca0a,{'file_name': '367ca0a'},qss,0,0,0
581cb2d,{'file_name': '581cb2d'},ui,0,0,0
7cece1a,{'file_name': '7cece1a'},py,4,3,7
06bc413,{'file_name': '06bc413'},md,6,23,29
d500f4b,{'file_name': 'd500f4b'},pickle,0,0,0
7674548,{'file_name': '7674548'},doctree,0,0,0
5f06022,{'file_name': '5f06022'},doctree,0,0,0
4f7ddd1,{'file_name': '4f7ddd1'},doctree,0,0,0
de7008c,{'file_name': 'de7008c'},doctree,0,0,0
18ada79,{'file_name': '18ada79'},txt,1,1,2
4b6f463,{'file_name': '4b6f463'},txt,2,3,5
5e8c591,{'file_name': '5e8c591'},txt,2,2,4
21fb570,{'file_name': '21fb570'},txt,3,3,6
fd548c1,{'file_name': 'fd548c1'},html,0,1,1
16dd976,{'file_name': '16dd976'},html,1,2,3
c4bf120,{'file_name': 'c4bf120'},html,5,10,15
92e0ba3,{'file_name': '92e0ba3'},html,4,5,9
1ab4042,{'file_name': '1ab4042'},inv,0,0,0
ed4b15a,{'file_name': 'ed4b15a'},html,0,1,1
80a21f9,{'file_name': '80a21f9'},js,1,1,2
153b9b2,{'file_name': '153b9b2'},html,3,7,10
56c32b6,{'file_name': '56c32b6'},rst,0,9,9
18ada79,{'file_name': '18ada79'},rst,1,1,2
4b6f463,{'file_name': '4b6f463'},rst,2,3,5
5e8c591,{'file_name': '5e8c591'},rst,2,2,4
21fb570,{'file_name': '21fb570'},rst,3,3,6
a33705d,{'file_name': 'a33705d'},md,7,1,8
ccf0d91,{'file_name': 'ccf0d91'},py,92,0,92
be08de5,{'file_name': 'be08de5'},py,213,0,213
7cc4365,{'file_name': '7cc4365'},py,92,0,92
03f6ac3,{'file_name': '03f6ac3'},py,56,0,56
c5d415f,{'file_name': 'c5d415f'},py,156,0,156
f51d655,{'file_name': 'f51d655'},py,0,1,1
a954b80,{'file_name': 'a954b80'},py,7,1,8
26305ef,{'file_name': '26305ef'},py,8,12,20
3e865c2,{'file_name': '3e865c2'},py,36,0,36
69eb68f,{'file_name': '69eb68f'},py,3,5,8
592c84a,{'file_name': '592c84a'},py,0,21,21
581cb2d,{'file_name': '581cb2d'},ui,0,1,1
28dce88,{'file_name': '28dce88'},md,2,0,2
5093829,{'file_name': '5093829'},py,7,16,23
389e842,{'file_name': '389e842'},py,0,67,67
d082c89,{'file_name': 'd082c89'},ini,0,17,17
48ca556,{'file_name': '48ca556'},mod,5,0,5
9aff6d6,{'file_name': '9aff6d6'},json,0,16,16
6f1c0fc,{'file_name': '6f1c0fc'},ma,0,84,84
52e6694,{'file_name': '52e6694'},json,0,16,16
4defd9a,{'file_name': '4defd9a'},ma,0,86,86
6ef6fb8,{'file_name': '6ef6fb8'},json,0,16,16
04379c0,{'file_name': '04379c0'},ma,0,82,82
2036aa9,{'file_name': '2036aa9'},json,0,16,16
64f605b,{'file_name': '64f605b'},ma,0,83,83
67e4b27,{'file_name': '67e4b27'},png,0,0,0
b130671,{'file_name': 'b130671'},json,0,16,16
66314cc,{'file_name': '66314cc'},ma,0,237,237
37078f3,{'file_name': '37078f3'},png,0,0,0
d8bdf1b,{'file_name': 'd8bdf1b'},ma,0,237,237
2c54eed,{'file_name': '2c54eed'},png,0,0,0
75ebd78,{'file_name': '75ebd78'},json,0,16,16
5c9ea6f,{'file_name': '5c9ea6f'},json,0,16,16
3c98644,{'file_name': '3c98644'},ma,0,82,82
3533805,{'file_name': '3533805'},ma,0,0,0
e956113,{'file_name': 'e956113'},json,2,2,4
7e611c8,{'file_name': '7e611c8'},ma,0,0,0
7d5c9d0,{'file_name': '7d5c9d0'},png,0,0,0
e8d1330,{'file_name': 'e8d1330'},json,1,1,2
60703e5,{'file_name': '60703e5'},ma,0,0,0
263eac9,{'file_name': '263eac9'},png,0,0,0
985e9eb,{'file_name': '985e9eb'},json,2,2,4
1a01782,{'file_name': '1a01782'},ma,0,0,0
de0304e,{'file_name': 'de0304e'},png,0,0,0
e69de29,{'file_name': 'e69de29'},py,0,0,0
e69de29,{'file_name': 'e69de29'},py,0,0,0
e69de29,{'file_name': 'e69de29'},py,0,0,0
e69de29,{'file_name': 'e69de29'},py,0,0,0
8732629,{'file_name': '8732629'},py,0,0,0
f8e055c,{'file_name': 'f8e055c'},py,0,0,0
da01e38,{'file_name': 'da01e38'},py,0,0,0
fe7edba,{'file_name': 'fe7edba'},py,0,0,0
e69de29,{'file_name': 'e69de29'},py,0,0,0
03847c2,{'file_name': '03847c2'},py,0,0,0
93b4423,{'file_name': '93b4423'},jpg,0,0,0
40bba92,{'file_name': '40bba92'},py,0,0,0
86feb5d,{'file_name': '86feb5d'},py,0,0,0
e69de29,{'file_name': 'e69de29'},py,0,0,0
f2af251,{'file_name': 'f2af251'},py,0,0,0
8e6183a,{'file_name': '8e6183a'},py,0,0,0
08f5d37,{'file_name': '08f5d37'},py,0,0,0
e69de29,{'file_name': 'e69de29'},py,0,0,0
46fd49f,{'file_name': '46fd49f'},py,0,0,0
2d4e823,{'file_name': '2d4e823'},png,0,0,0
d25b0c8,{'file_name': 'd25b0c8'},png,0,0,0
fb4221f,{'file_name': 'fb4221f'},png,0,0,0
81deb74,{'file_name': '81deb74'},png,0,0,0
b0f43f2,{'file_name': 'b0f43f2'},png,0,0,0
4d95013,{'file_name': '4d95013'},png,0,0,0
070e4aa,{'file_name': '070e4aa'},png,0,0,0
87f784b,{'file_name': '87f784b'},png,0,0,0
20d809e,{'file_name': '20d809e'},png,0,0,0
c8dd7ad,{'file_name': 'c8dd7ad'},png,0,0,0
24caeec,{'file_name': '24caeec'},png,0,0,0
5e96f18,{'file_name': '5e96f18'},png,0,0,0
d4cd4ad,{'file_name': 'd4cd4ad'},png,0,0,0
2d921b2,{'file_name': '2d921b2'},psd,0,0,0
2d9d2e5,{'file_name': '2d9d2e5'},png,0,0,0
5ade957,{'file_name': '5ade957'},png,0,0,0
2ead35e,{'file_name': '2ead35e'},qss,0,0,0
367ca0a,{'file_name': '367ca0a'},qss,0,0,0
cb40e77,{'file_name': 'cb40e77'},py,0,0,0
2bcf7d8,{'file_name': '2bcf7d8'},py,0,93,93
3f0634b,{'file_name': '3f0634b'},py,0,211,211
5f3e777,{'file_name': '5f3e777'},py,0,93,93
8117f06,{'file_name': '8117f06'},py,0,66,66
a528b19,{'file_name': 'a528b19'},py,0,156,156
b8e0509,{'file_name': 'b8e0509'},pickle,0,0,0
ee85328,{'file_name': 'ee85328'},doctree,0,0,0
3766e2a,{'file_name': '3766e2a'},txt,12,2,14
3b21512,{'file_name': '3b21512'},html,1,0,1
053d6b1,{'file_name': '053d6b1'},html,11,2,13
d5b5b34,{'file_name': 'd5b5b34'},js,1,1,2
3766e2a,{'file_name': '3766e2a'},rst,12,2,14
e1efb7d,{'file_name': 'e1efb7d'},pickle,0,0,0
dd9e065,{'file_name': 'dd9e065'},doctree,0,0,0
b854900,{'file_name': 'b854900'},txt,1,1,2
fecd127,{'file_name': 'fecd127'},html,1,1,2
b854900,{'file_name': 'b854900'},rst,1,1,2
d218945,{'file_name': 'd218945'},pickle,0,0,0
b09ecd7,{'file_name': 'b09ecd7'},doctree,0,0,0
370a7e8,{'file_name': '370a7e8'},txt,2,2,4
3be2a76,{'file_name': '3be2a76'},html,2,2,4
007dd2b,{'file_name': '007dd2b'},md,1,1,2
eb5e1ae,{'file_name': 'eb5e1ae'},md,4,2,6
a25439d,{'file_name': 'a25439d'},md,4,2,6
370a7e8,{'file_name': '370a7e8'},rst,2,2,4
8c476d8,{'file_name': '8c476d8'},lock,58,45,103
0029314,{'file_name': '0029314'},rst,4,8,12
b6fb85f,{'file_name': 'b6fb85f'},py,1,3,4
bda69bb,{'file_name': 'bda69bb'},png,0,0,0
ca58f6e,{'file_name': 'ca58f6e'},gitignore,1,0,1
482933b,{'file_name': '482933b'},pickle,0,0,0
d4e7b2e,{'file_name': 'd4e7b2e'},doctree,0,0,0
d475c7f,{'file_name': 'd475c7f'},doctree,0,0,0
afd2e6e,{'file_name': 'afd2e6e'},doctree,0,0,0
becd071,{'file_name': 'becd071'},doctree,0,0,0
44843db,{'file_name': '44843db'},buildinfo,1,1,2
379cdaf,{'file_name': '379cdaf'},txt,5,4,9
e380325,{'file_name': 'e380325'},css,1,1,2
6cb6000,{'file_name': '6cb6000'},woff,0,0,0
7059e23,{'file_name': '7059e23'},woff2,0,0,0
f815f63,{'file_name': 'f815f63'},woff,0,0,0
f2c76e5,{'file_name': 'f2c76e5'},woff2,0,0,0
e9f60ca,{'file_name': 'e9f60ca'},eot,0,0,0
855c845,{'file_name': '855c845'},svg,2671,0,2671
35acda2,{'file_name': '35acda2'},ttf,0,0,0
400014a,{'file_name': '400014a'},woff,0,0,0
4d13fc6,{'file_name': '4d13fc6'},woff2,0,0,0
88ad05b,{'file_name': '88ad05b'},woff,0,0,0
c4e3d80,{'file_name': 'c4e3d80'},woff2,0,0,0
c6dff51,{'file_name': 'c6dff51'},woff,0,0,0
bb19504,{'file_name': 'bb19504'},woff2,0,0,0
76114bc,{'file_name': '76114bc'},woff,0,0,0
3404f37,{'file_name': '3404f37'},woff2,0,0,0
ae1307f,{'file_name': 'ae1307f'},woff,0,0,0
3bf9843,{'file_name': '3bf9843'},woff2,0,0,0
8cd4f10,{'file_name': '8cd4f10'},css,2,4,6
401ec0f,{'file_name': '401ec0f'},otf,0,0,0
6cb6000,{'file_name': '6cb6000'},woff,0,0,0
7059e23,{'file_name': '7059e23'},woff2,0,0,0
337d287,{'file_name': '337d287'},woff,0,0,0
20398af,{'file_name': '20398af'},woff2,0,0,0
f815f63,{'file_name': 'f815f63'},woff,0,0,0
f2c76e5,{'file_name': 'f2c76e5'},woff2,0,0,0
6b30ea6,{'file_name': '6b30ea6'},woff,0,0,0
328f5bb,{'file_name': '328f5bb'},woff2,0,0,0
88ad05b,{'file_name': '88ad05b'},woff,0,0,0
c4e3d80,{'file_name': 'c4e3d80'},woff2,0,0,0
c6dff51,{'file_name': 'c6dff51'},woff,0,0,0
bb19504,{'file_name': 'bb19504'},woff2,0,0,0
76114bc,{'file_name': '76114bc'},woff,0,0,0
3404f37,{'file_name': '3404f37'},woff2,0,0,0
ae1307f,{'file_name': 'ae1307f'},woff,0,0,0
3bf9843,{'file_name': '3bf9843'},woff2,0,0,0
526d723,{'file_name': '526d723'},js,1,0,1
2b43bd0,{'file_name': '2b43bd0'},js,4,0,4
cd1c674,{'file_name': 'cd1c674'},js,4,0,4
839d07e,{'file_name': '839d07e'},js,1,3,4
a535abd,{'file_name': 'a535abd'},html,21,11,32
481551c,{'file_name': '481551c'},html,21,11,32
fa521e0,{'file_name': 'fa521e0'},html,21,11,32
1f5a949,{'file_name': '1f5a949'},html,27,16,43
dea7e36,{'file_name': 'dea7e36'},html,24,14,38
5e17b81,{'file_name': '5e17b81'},js,1,1,2
1810347,{'file_name': '1810347'},html,21,11,32
379cdaf,{'file_name': '379cdaf'},rst,4,3,7
9187b8d,{'file_name': '9187b8d'},Pipfile,13,0,13
1bfa95d,{'file_name': '1bfa95d'},lock,210,0,210
f64a3ec,{'file_name': 'f64a3ec'},py,1,1,2
e5ec85b,{'file_name': 'e5ec85b'},md,1,1,2
26596bd,{'file_name': '26596bd'},rst,4,4,8
48ca556,{'file_name': '48ca556'},mod,0,5,5
5093829,{'file_name': '5093829'},py,0,28,28
e69de29,{'file_name': 'e69de29'},py,0,0,0
e69de29,{'file_name': 'e69de29'},py,0,0,0
e69de29,{'file_name': 'e69de29'},py,0,0,0
a650bca,{'file_name': 'a650bca'},py,1,1,2
e69de29,{'file_name': 'e69de29'},py,0,0,0
ccf0d91,{'file_name': 'ccf0d91'},py,1,1,2
be08de5,{'file_name': 'be08de5'},py,1,1,2
e69de29,{'file_name': 'e69de29'},py,0,0,0
7cc4365,{'file_name': '7cc4365'},py,0,0,0
8732629,{'file_name': '8732629'},py,0,0,0
f8e055c,{'file_name': 'f8e055c'},py,0,0,0
f51d655,{'file_name': 'f51d655'},py,0,0,0
da01e38,{'file_name': 'da01e38'},py,0,0,0
fe7edba,{'file_name': 'fe7edba'},py,0,0,0
03f6ac3,{'file_name': '03f6ac3'},py,0,0,0
e69de29,{'file_name': 'e69de29'},py,0,0,0
03847c2,{'file_name': '03847c2'},py,0,0,0
69eb68f,{'file_name': '69eb68f'},py,0,0,0
93b4423,{'file_name': '93b4423'},jpg,0,0,0
40bba92,{'file_name': '40bba92'},py,1,1,2
86feb5d,{'file_name': '86feb5d'},py,0,0,0
c5d415f,{'file_name': 'c5d415f'},py,2,2,4
e69de29,{'file_name': 'e69de29'},py,0,0,0
a954b80,{'file_name': 'a954b80'},py,0,0,0
f2af251,{'file_name': 'f2af251'},py,0,0,0
8e6183a,{'file_name': '8e6183a'},py,0,0,0
08f5d37,{'file_name': '08f5d37'},py,0,0,0
28dce88,{'file_name': '28dce88'},md,0,0,0
0cc5562,{'file_name': '0cc5562'},py,0,0,0
e69de29,{'file_name': 'e69de29'},py,0,0,0
46fd49f,{'file_name': '46fd49f'},py,0,0,0
2d4e823,{'file_name': '2d4e823'},png,0,0,0
d25b0c8,{'file_name': 'd25b0c8'},png,0,0,0
c37046b,{'file_name': 'c37046b'},png,0,0,0
81deb74,{'file_name': '81deb74'},png,0,0,0
b0f43f2,{'file_name': 'b0f43f2'},png,0,0,0
4d95013,{'file_name': '4d95013'},png,0,0,0
070e4aa,{'file_name': '070e4aa'},png,0,0,0
87f784b,{'file_name': '87f784b'},png,0,0,0
20d809e,{'file_name': '20d809e'},png,0,0,0
c8dd7ad,{'file_name': 'c8dd7ad'},png,0,0,0
24caeec,{'file_name': '24caeec'},png,0,0,0
5e96f18,{'file_name': '5e96f18'},png,0,0,0
d4cd4ad,{'file_name': 'd4cd4ad'},png,0,0,0
2d921b2,{'file_name': '2d921b2'},psd,0,0,0
2d9d2e5,{'file_name': '2d9d2e5'},png,0,0,0
5ade957,{'file_name': '5ade957'},png,0,0,0
2ead35e,{'file_name': '2ead35e'},qss,0,0,0
367ca0a,{'file_name': '367ca0a'},qss,0,0,0
581cb2d,{'file_name': '581cb2d'},ui,0,0,0
7cece1a,{'file_name': '7cece1a'},py,0,0,0
1325944,{'file_name': '1325944'},rst,1,1,2
e69de29,{'file_name': 'e69de29'},py,0,36,36
6c3ce4c,{'file_name': '6c3ce4c'},py,40,0,40
c37046b,{'file_name': 'c37046b'},png,0,0,0
fb4221f,{'file_name': 'fb4221f'},png,0,0,0
e69de29,{'file_name': 'e69de29'},py,0,0,0
b5aa3eb,{'file_name': 'b5aa3eb'},py,1,1,2
3e25a1d,{'file_name': '3e25a1d'},py,1,1,2
e69de29,{'file_name': 'e69de29'},py,0,0,0
7cc4365,{'file_name': '7cc4365'},py,0,0,0
8732629,{'file_name': '8732629'},py,0,0,0
f8e055c,{'file_name': 'f8e055c'},py,0,0,0
f51d655,{'file_name': 'f51d655'},py,0,0,0
da01e38,{'file_name': 'da01e38'},py,0,0,0
fe7edba,{'file_name': 'fe7edba'},py,0,0,0
03f6ac3,{'file_name': '03f6ac3'},py,0,0,0
e69de29,{'file_name': 'e69de29'},py,0,0,0
03847c2,{'file_name': '03847c2'},py,0,0,0
69eb68f,{'file_name': '69eb68f'},py,0,0,0
93b4423,{'file_name': '93b4423'},jpg,0,0,0
67e8746,{'file_name': '67e8746'},py,1,1,2
86feb5d,{'file_name': '86feb5d'},py,0,0,0
3fce6fe,{'file_name': '3fce6fe'},py,2,2,4
e69de29,{'file_name': 'e69de29'},py,0,0,0
a954b80,{'file_name': 'a954b80'},py,0,0,0
f2af251,{'file_name': 'f2af251'},py,0,0,0
8e6183a,{'file_name': '8e6183a'},py,0,0,0
08f5d37,{'file_name': '08f5d37'},py,0,0,0
0cc5562,{'file_name': '0cc5562'},py,1,1,2
28dce88,{'file_name': '28dce88'},md,0,0,0
e69de29,{'file_name': 'e69de29'},py,0,0,0
46fd49f,{'file_name': '46fd49f'},py,0,0,0
2d4e823,{'file_name': '2d4e823'},png,0,0,0
d25b0c8,{'file_name': 'd25b0c8'},png,0,0,0
81deb74,{'file_name': '81deb74'},png,0,0,0
b0f43f2,{'file_name': 'b0f43f2'},png,0,0,0
4d95013,{'file_name': '4d95013'},png,0,0,0
070e4aa,{'file_name': '070e4aa'},png,0,0,0
87f784b,{'file_name': '87f784b'},png,0,0,0
20d809e,{'file_name': '20d809e'},png,0,0,0
c8dd7ad,{'file_name': 'c8dd7ad'},png,0,0,0
24caeec,{'file_name': '24caeec'},png,0,0,0
5e96f18,{'file_name': '5e96f18'},png,0,0,0
d4cd4ad,{'file_name': 'd4cd4ad'},png,0,0,0
2d921b2,{'file_name': '2d921b2'},psd,0,0,0
2d9d2e5,{'file_name': '2d9d2e5'},png,0,0,0
5ade957,{'file_name': '5ade957'},png,0,0,0
2ead35e,{'file_name': '2ead35e'},qss,0,0,0
367ca0a,{'file_name': '367ca0a'},qss,0,0,0
581cb2d,{'file_name': '581cb2d'},ui,0,0,0
7cece1a,{'file_name': '7cece1a'},py,4,3,7
06bc413,{'file_name': '06bc413'},md,6,23,29
d500f4b,{'file_name': 'd500f4b'},pickle,0,0,0
7674548,{'file_name': '7674548'},doctree,0,0,0
5f06022,{'file_name': '5f06022'},doctree,0,0,0
4f7ddd1,{'file_name': '4f7ddd1'},doctree,0,0,0
de7008c,{'file_name': 'de7008c'},doctree,0,0,0
18ada79,{'file_name': '18ada79'},txt,1,1,2
4b6f463,{'file_name': '4b6f463'},txt,2,3,5
5e8c591,{'file_name': '5e8c591'},txt,2,2,4
21fb570,{'file_name': '21fb570'},txt,3,3,6
fd548c1,{'file_name': 'fd548c1'},html,0,1,1
16dd976,{'file_name': '16dd976'},html,1,2,3
c4bf120,{'file_name': 'c4bf120'},html,5,10,15
92e0ba3,{'file_name': '92e0ba3'},html,4,5,9
1ab4042,{'file_name': '1ab4042'},inv,0,0,0
ed4b15a,{'file_name': 'ed4b15a'},html,0,1,1
80a21f9,{'file_name': '80a21f9'},js,1,1,2
153b9b2,{'file_name': '153b9b2'},html,3,7,10
56c32b6,{'file_name': '56c32b6'},rst,0,9,9
18ada79,{'file_name': '18ada79'},rst,1,1,2
4b6f463,{'file_name': '4b6f463'},rst,2,3,5
5e8c591,{'file_name': '5e8c591'},rst,2,2,4
21fb570,{'file_name': '21fb570'},rst,3,3,6
a33705d,{'file_name': 'a33705d'},md,7,1,8
ccf0d91,{'file_name': 'ccf0d91'},py,92,0,92
be08de5,{'file_name': 'be08de5'},py,213,0,213
7cc4365,{'file_name': '7cc4365'},py,92,0,92
03f6ac3,{'file_name': '03f6ac3'},py,56,0,56
c5d415f,{'file_name': 'c5d415f'},py,156,0,156
f51d655,{'file_name': 'f51d655'},py,0,1,1
a954b80,{'file_name': 'a954b80'},py,7,1,8
26305ef,{'file_name': '26305ef'},py,8,12,20
3e865c2,{'file_name': '3e865c2'},py,36,0,36
69eb68f,{'file_name': '69eb68f'},py,3,5,8
592c84a,{'file_name': '592c84a'},py,0,21,21
581cb2d,{'file_name': '581cb2d'},ui,0,1,1
28dce88,{'file_name': '28dce88'},md,2,0,2
5093829,{'file_name': '5093829'},py,7,16,23
389e842,{'file_name': '389e842'},py,0,67,67
d082c89,{'file_name': 'd082c89'},ini,0,17,17
48ca556,{'file_name': '48ca556'},mod,5,0,5
9aff6d6,{'file_name': '9aff6d6'},json,0,16,16
6f1c0fc,{'file_name': '6f1c0fc'},ma,0,84,84
52e6694,{'file_name': '52e6694'},json,0,16,16
4defd9a,{'file_name': '4defd9a'},ma,0,86,86
6ef6fb8,{'file_name': '6ef6fb8'},json,0,16,16
04379c0,{'file_name': '04379c0'},ma,0,82,82
2036aa9,{'file_name': '2036aa9'},json,0,16,16
64f605b,{'file_name': '64f605b'},ma,0,83,83
67e4b27,{'file_name': '67e4b27'},png,0,0,0
b130671,{'file_name': 'b130671'},json,0,16,16
66314cc,{'file_name': '66314cc'},ma,0,237,237
37078f3,{'file_name': '37078f3'},png,0,0,0
d8bdf1b,{'file_name': 'd8bdf1b'},ma,0,237,237
2c54eed,{'file_name': '2c54eed'},png,0,0,0
75ebd78,{'file_name': '75ebd78'},json,0,16,16
5c9ea6f,{'file_name': '5c9ea6f'},json,0,16,16
3c98644,{'file_name': '3c98644'},ma,0,82,82
3533805,{'file_name': '3533805'},ma,0,0,0
e956113,{'file_name': 'e956113'},json,2,2,4
7e611c8,{'file_name': '7e611c8'},ma,0,0,0
7d5c9d0,{'file_name': '7d5c9d0'},png,0,0,0
e8d1330,{'file_name': 'e8d1330'},json,1,1,2
60703e5,{'file_name': '60703e5'},ma,0,0,0
263eac9,{'file_name': '263eac9'},png,0,0,0
985e9eb,{'file_name': '985e9eb'},json,2,2,4
1a01782,{'file_name': '1a01782'},ma,0,0,0
de0304e,{'file_name': 'de0304e'},png,0,0,0
e69de29,{'file_name': 'e69de29'},py,0,0,0
e69de29,{'file_name': 'e69de29'},py,0,0,0
e69de29,{'file_name': 'e69de29'},py,0,0,0
e69de29,{'file_name': 'e69de29'},py,0,0,0
8732629,{'file_name': '8732629'},py,0,0,0
f8e055c,{'file_name': 'f8e055c'},py,0,0,0
da01e38,{'file_name': 'da01e38'},py,0,0,0
fe7edba,{'file_name': 'fe7edba'},py,0,0,0
e69de29,{'file_name': 'e69de29'},py,0,0,0
03847c2,{'file_name': '03847c2'},py,0,0,0
93b4423,{'file_name': '93b4423'},jpg,0,0,0
40bba92,{'file_name': '40bba92'},py,0,0,0
86feb5d,{'file_name': '86feb5d'},py,0,0,0
e69de29,{'file_name': 'e69de29'},py,0,0,0
f2af251,{'file_name': 'f2af251'},py,0,0,0
8e6183a,{'file_name': '8e6183a'},py,0,0,0
08f5d37,{'file_name': '08f5d37'},py,0,0,0
e69de29,{'file_name': 'e69de29'},py,0,0,0
46fd49f,{'file_name': '46fd49f'},py,0,0,0
2d4e823,{'file_name': '2d4e823'},png,0,0,0
d25b0c8,{'file_name': 'd25b0c8'},png,0,0,0
fb4221f,{'file_name': 'fb4221f'},png,0,0,0
81deb74,{'file_name': '81deb74'},png,0,0,0
b0f43f2,{'file_name': 'b0f43f2'},png,0,0,0
4d95013,{'file_name': '4d95013'},png,0,0,0
070e4aa,{'file_name': '070e4aa'},png,0,0,0
87f784b,{'file_name': '87f784b'},png,0,0,0
20d809e,{'file_name': '20d809e'},png,0,0,0
c8dd7ad,{'file_name': 'c8dd7ad'},png,0,0,0
24caeec,{'file_name': '24caeec'},png,0,0,0
5e96f18,{'file_name': '5e96f18'},png,0,0,0
d4cd4ad,{'file_name': 'd4cd4ad'},png,0,0,0
2d921b2,{'file_name': '2d921b2'},psd,0,0,0
2d9d2e5,{'file_name': '2d9d2e5'},png,0,0,0
5ade957,{'file_name': '5ade957'},png,0,0,0
2ead35e,{'file_name': '2ead35e'},qss,0,0,0
367ca0a,{'file_name': '367ca0a'},qss,0,0,0
cb40e77,{'file_name': 'cb40e77'},py,0,0,0
2bcf7d8,{'file_name': '2bcf7d8'},py,0,93,93
3f0634b,{'file_name': '3f0634b'},py,0,211,211
5f3e777,{'file_name': '5f3e777'},py,0,93,93
8117f06,{'file_name': '8117f06'},py,0,66,66
a528b19,{'file_name': 'a528b19'},py,0,156,156
b8e0509,{'file_name': 'b8e0509'},pickle,0,0,0
ee85328,{'file_name': 'ee85328'},doctree,0,0,0
3766e2a,{'file_name': '3766e2a'},txt,12,2,14
3b21512,{'file_name': '3b21512'},html,1,0,1
053d6b1,{'file_name': '053d6b1'},html,11,2,13
d5b5b34,{'file_name': 'd5b5b34'},js,1,1,2
3766e2a,{'file_name': '3766e2a'},rst,12,2,14
e1efb7d,{'file_name': 'e1efb7d'},pickle,0,0,0
dd9e065,{'file_name': 'dd9e065'},doctree,0,0,0
b854900,{'file_name': 'b854900'},txt,1,1,2
fecd127,{'file_name': 'fecd127'},html,1,1,2
b854900,{'file_name': 'b854900'},rst,1,1,2
d218945,{'file_name': 'd218945'},pickle,0,0,0
b09ecd7,{'file_name': 'b09ecd7'},doctree,0,0,0
370a7e8,{'file_name': '370a7e8'},txt,2,2,4
3be2a76,{'file_name': '3be2a76'},html,2,2,4
007dd2b,{'file_name': '007dd2b'},md,1,1,2
eb5e1ae,{'file_name': 'eb5e1ae'},md,4,2,6
f5e4278,{'file_name': 'f5e4278'},py,0,14,14
4b85d66,{'file_name': '4b85d66'},py,0,29,29
4d1eb15,{'file_name': '4d1eb15'},md,8,2,10
34a980e,{'file_name': '34a980e'},py,3,4,7
f5d027e,{'file_name': 'f5d027e'},py,0,3,3
bbadb2b,{'file_name': 'bbadb2b'},py,142,162,304
20a2dfc,{'file_name': '20a2dfc'},py,1,1,2
590b5da,{'file_name': '590b5da'},py,2,6,8
f7ebc7f,{'file_name': 'f7ebc7f'},ui,13,26,39
4598cb9,{'file_name': '4598cb9'},ui,47,117,164
e8e6265,{'file_name': 'e8e6265'},py,40,67,107
05ba921,{'file_name': '05ba921'},py,7,4,11
93e97da,{'file_name': '93e97da'},py,47,13,60
7e4dc0f,{'file_name': '7e4dc0f'},py,79,58,137
e69de29,{'file_name': 'e69de29'},py,0,32,32
9dd714e,{'file_name': '9dd714e'},py,41,0,41
5bbd101,{'file_name': '5bbd101'},qss,0,44,44
4d051e0,{'file_name': '4d051e0'},py,0,281,281
99456b0,{'file_name': '99456b0'},qss,0,136,136
1eec94a,{'file_name': '1eec94a'},py,0,54,54
9f49000,{'file_name': '9f49000'},py,0,13,13
4d051e0,{'file_name': '4d051e0'},py,45,66,111
47f8a4e,{'file_name': '47f8a4e'},py,0,46,46
b144f8f,{'file_name': 'b144f8f'},ui,1,1,2
21450c0,{'file_name': '21450c0'},py,13,0,13
d38fbca,{'file_name': 'd38fbca'},py,4,6,10
6a357a6,{'file_name': '6a357a6'},py,6,1,7
1eec94a,{'file_name': '1eec94a'},py,54,0,54
9f49000,{'file_name': '9f49000'},py,13,0,13
6f2356b,{'file_name': '6f2356b'},py,302,0,302
47f8a4e,{'file_name': '47f8a4e'},py,46,0,46
9fbe2ab,{'file_name': '9fbe2ab'},py,2,5,7
cc6df22,{'file_name': 'cc6df22'},py,14,0,14
b27c765,{'file_name': 'b27c765'},py,14,14,28
3838afb,{'file_name': '3838afb'},py,0,180,180
c18488e,{'file_name': 'c18488e'},py,133,34,167
b1dfb30,{'file_name': 'b1dfb30'},py,72,49,121
a48d3d5,{'file_name': 'a48d3d5'},md,9,0,9
a685049,{'file_name': 'a685049'},py,201,0,201
d146a5c,{'file_name': 'd146a5c'},py,0,104,104
3838afb,{'file_name': '3838afb'},py,1,20,21
21c6495,{'file_name': '21c6495'},py,0,79,79
dddbf36,{'file_name': 'dddbf36'},py,134,0,134
bc24d62,{'file_name': 'bc24d62'},ui,703,0,703
d310f93,{'file_name': 'd310f93'},py,18,0,18
e69de29,{'file_name': 'e69de29'},py,0,0,0
e69de29,{'file_name': 'e69de29'},py,0,0,0
d146a5c,{'file_name': 'd146a5c'},py,104,0,104
2a1f98e,{'file_name': '2a1f98e'},py,199,0,199
21c6495,{'file_name': '21c6495'},py,79,0,79
9837f97,{'file_name': '9837f97'},md,4,5,9
5359a6a,{'file_name': '5359a6a'},py,4,3,7
f0b6185,{'file_name': 'f0b6185'},py,92,105,197
328d5d7,{'file_name': '328d5d7'},ui,479,242,721
cbad7e4,{'file_name': 'cbad7e4'},py,25,39,64
3395ffa,{'file_name': '3395ffa'},ui,0,129,129
5bbd101,{'file_name': '5bbd101'},qss,44,0,44
e4a06af,{'file_name': 'e4a06af'},lock,114,47,161
e4a06af,{'file_name': 'e4a06af'},lock,114,47,161
9aba3b8,{'file_name': '9aba3b8'},py,2,1,3
a63bc8d,{'file_name': 'a63bc8d'},md,12,0,12
5c10f99,{'file_name': '5c10f99'},py,3,1,4
0c16730,{'file_name': '0c16730'},ini,19,2,21
8f81f08,{'file_name': '8f81f08'},json,3,3,6
602704f,{'file_name': '602704f'},json,2,2,4
55e3964,{'file_name': '55e3964'},py,5,4,9
0cf155e,{'file_name': '0cf155e'},py,65,61,126
9373a4c,{'file_name': '9373a4c'},py,61,20,81
0401808,{'file_name': '0401808'},json,2,2,4
ca96f40,{'file_name': 'ca96f40'},json,3,3,6
8eb8233,{'file_name': '8eb8233'},json,0,3,3
8eb8233,{'file_name': '8eb8233'},json,0,3,3
1b85611,{'file_name': '1b85611'},json,6,6,12
0cd026b,{'file_name': '0cd026b'},Pipfile,2,0,2
41ec082,{'file_name': '41ec082'},lock,140,1,141
a925705,{'file_name': 'a925705'},ini,10,7,17
7a96b03,{'file_name': '7a96b03'},json,5,5,10
bb85332,{'file_name': 'bb85332'},json,5,5,10
2243322,{'file_name': '2243322'},py,1,1,2
860457e,{'file_name': '860457e'},Pipfile,6,11,17
b3e921f,{'file_name': 'b3e921f'},lock,19,543,562
f1c363b,{'file_name': 'f1c363b'},py,82,0,82
14078bb,{'file_name': '14078bb'},yml,2,2,4
817c832,{'file_name': '817c832'},ini,1,0,1
f26afd2,{'file_name': 'f26afd2'},yml,6,5,11
d52350b,{'file_name': 'd52350b'},yml,0,35,35
9fe8401,{'file_name': '9fe8401'},ini,8,3,11
4f92ee4,{'file_name': '4f92ee4'},py,0,2,2
9fa3a4e,{'file_name': '9fa3a4e'},yml,2,0,2
4ecf096,{'file_name': '4ecf096'},json,2,2,4
3753499,{'file_name': '3753499'},json,3,3,6
76d51d7,{'file_name': '76d51d7'},Pipfile,2,0,2
89416b9,{'file_name': '89416b9'},lock,65,1,66
0a9f65c,{'file_name': '0a9f65c'},ini,2,1,3
01ebc02,{'file_name': '01ebc02'},ini,1,1,2
e69de29,{'file_name': 'e69de29'},yml,0,0,0
f17f2d4,{'file_name': 'f17f2d4'},py,1,1,2
19e1194,{'file_name': '19e1194'},py,2,1,3
2278920,{'file_name': '2278920'},md,3,3,6
3c3ad52,{'file_name': '3c3ad52'},py,1,0,1
8ed434e,{'file_name': '8ed434e'},ini,1,0,1
2dc8f45,{'file_name': '2dc8f45'},md,2,0,2
97654a3,{'file_name': '97654a3'},rst,22,0,22
a720a17,{'file_name': 'a720a17'},rst,11,2,13
a3f04bf,{'file_name': 'a3f04bf'},rst,4,0,4
1a74359,{'file_name': '1a74359'},py,11,7,18
3d909c1,{'file_name': '3d909c1'},py,1,1,2
416b92b,{'file_name': '416b92b'},py,1,1,2
f5a5472,{'file_name': 'f5a5472'},py,1,1,2
d322566,{'file_name': 'd322566'},ini,1,1,2
3248250,{'file_name': '3248250'},lock,132,122,254
4fd7754,{'file_name': '4fd7754'},py,4,2,6
c56d7cd,{'file_name': 'c56d7cd'},py,68,34,102
c56d7cd,{'file_name': 'c56d7cd'},py,68,34,102
a664a7d,{'file_name': 'a664a7d'},lock,18,18,36
0503d07,{'file_name': '0503d07'},lock,72,72,144
bbd2eac,{'file_name': 'bbd2eac'},lock,129,125,254
0435943,{'file_name': '0435943'},lock,42,43,85
3aefe39,{'file_name': '3aefe39'},py,1,1,2
8f9a437,{'file_name': '8f9a437'},ini,1,0,1
cf0799d,{'file_name': 'cf0799d'},ini,2,2,4
52c2aa7,{'file_name': '52c2aa7'},yml,1,1,2
e62119f,{'file_name': 'e62119f'},ini,2,1,3
e49bede,{'file_name': 'e49bede'},yml,2,2,4
7889c40,{'file_name': '7889c40'},ini,13,1,14
8629551,{'file_name': '8629551'},code-workspace,0,12,12
4ad5d0e,{'file_name': '4ad5d0e'},gitignore,0,1,1
8629551,{'file_name': '8629551'},code-workspace,12,0,12
8629551,{'file_name': '8629551'},code-workspace,0,12,12
aaa044e,{'file_name': 'aaa044e'},py,1,1,2
4493ec0,{'file_name': '4493ec0'},py,2,2,4
7917dc8,{'file_name': '7917dc8'},rst,6,0,6
175d713,{'file_name': '175d713'},md,5,0,5
2edfe92,{'file_name': '2edfe92'},py,1,1,2
4c8155a,{'file_name': '4c8155a'},py,0,1,1
f4459e6,{'file_name': 'f4459e6'},ini,1,1,2
ee078fa,{'file_name': 'ee078fa'},txt,619,0,619
fa8f76b,{'file_name': 'fa8f76b'},Pipfile,1,0,1
c969b7a,{'file_name': 'c969b7a'},lock,75,10,85
224a779,{'file_name': '224a779'},cfg,2,0,2
896bfc4,{'file_name': '896bfc4'},py,7,3,10
ac41275,{'file_name': 'ac41275'},py,16,0,16
4ea32d4,{'file_name': '4ea32d4'},py,11,0,11
5c3f549,{'file_name': '5c3f549'},py,11,0,11
0d8a4ca,{'file_name': '0d8a4ca'},py,11,0,11
5f2823a,{'file_name': '5f2823a'},py,11,0,11
ad2dd95,{'file_name': 'ad2dd95'},yml,4,1,5
265d4e6,{'file_name': '265d4e6'},ini,18,7,25
d70e8a2,{'file_name': 'd70e8a2'},yml,3,1,4
d09ae0f,{'file_name': 'd09ae0f'},Pipfile,1,0,1
a2ef6cf,{'file_name': 'a2ef6cf'},lock,25,1,26
0638ae8,{'file_name': '0638ae8'},md,1,0,1
eba24b0,{'file_name': 'eba24b0'},md,4,0,4
f59711f,{'file_name': 'f59711f'},yml,1,1,2
5f2421c,{'file_name': '5f2421c'},yml,1,2,3
